ㄱㅏ	가
ㄱㅏㄱ	각
ㄱㅏㄲ	갂
ㄱㅏㄳ	갃
ㄱㅏㄴ	간
ㄱㅏㄵ	갅
ㄱㅏㄶ	갆
ㄱㅏㄷ	갇
ㄱㅏㄹ	갈
ㄱㅏㄺ	갉
ㄱㅏㄻ	갊
ㄱㅏㄼ	갋
ㄱㅏㄽ	갌
ㄱㅏㄾ	갍
ㄱㅏㄿ	갎
ㄱㅏㅀ	갏
ㄱㅏㅁ	감
ㄱㅏㅂ	갑
ㄱㅏㅄ	값
ㄱㅏㅅ	갓
ㄱㅏㅆ	갔
ㄱㅏㅇ	강
ㄱㅏㅈ	갖
ㄱㅏㅊ	갗
ㄱㅏㅋ	갘
ㄱㅏㅌ	같
ㄱㅏㅍ	갚
ㄱㅏㅎ	갛
ㄱㅐ	개
ㄱㅐㄱ	객
ㄱㅐㄲ	갞
ㄱㅐㄳ	갟
ㄱㅐㄴ	갠
ㄱㅐㄵ	갡
ㄱㅐㄶ	갢
ㄱㅐㄷ	갣
ㄱㅐㄹ	갤
ㄱㅐㄺ	갥
ㄱㅐㄻ	갦
ㄱㅐㄼ	갧
ㄱㅐㄽ	갨
ㄱㅐㄾ	갩
ㄱㅐㄿ	갪
ㄱㅐㅀ	갫
ㄱㅐㅁ	갬
ㄱㅐㅂ	갭
ㄱㅐㅄ	갮
ㄱㅐㅅ	갯
ㄱㅐㅆ	갰
ㄱㅐㅇ	갱
ㄱㅐㅈ	갲
ㄱㅐㅊ	갳
ㄱㅐㅋ	갴
ㄱㅐㅌ	갵
ㄱㅐㅍ	갶
ㄱㅐㅎ	갷
ㄱㅑ	갸
ㄱㅑㄱ	갹
ㄱㅑㄲ	갺
ㄱㅑㄳ	갻
ㄱㅑㄴ	갼
ㄱㅑㄵ	갽
ㄱㅑㄶ	갾
ㄱㅑㄷ	갿
ㄱㅑㄹ	걀
ㄱㅑㄺ	걁
ㄱㅑㄻ	걂
ㄱㅑㄼ	걃
ㄱㅑㄽ	걄
ㄱㅑㄾ	걅
ㄱㅑㄿ	걆
ㄱㅑㅀ	걇
ㄱㅑㅁ	걈
ㄱㅑㅂ	걉
ㄱㅑㅄ	걊
ㄱㅑㅅ	걋
ㄱㅑㅆ	걌
ㄱㅑㅇ	걍
ㄱㅑㅈ	걎
ㄱㅑㅊ	걏
ㄱㅑㅋ	걐
ㄱㅑㅌ	걑
ㄱㅑㅍ	걒
ㄱㅑㅎ	걓
ㄱㅒ	걔
ㄱㅒㄱ	걕
ㄱㅒㄲ	걖
ㄱㅒㄳ	걗
ㄱㅒㄴ	걘
ㄱㅒㄵ	걙
ㄱㅒㄶ	걚
ㄱㅒㄷ	걛
ㄱㅒㄹ	걜
ㄱㅒㄺ	걝
ㄱㅒㄻ	걞
ㄱㅒㄼ	걟
ㄱㅒㄽ	걠
ㄱㅒㄾ	걡
ㄱㅒㄿ	걢
ㄱㅒㅀ	걣
ㄱㅒㅁ	걤
ㄱㅒㅂ	걥
ㄱㅒㅄ	걦
ㄱㅒㅅ	걧
ㄱㅒㅆ	걨
ㄱㅒㅇ	걩
ㄱㅒㅈ	걪
ㄱㅒㅊ	걫
ㄱㅒㅋ	걬
ㄱㅒㅌ	걭
ㄱㅒㅍ	걮
ㄱㅒㅎ	걯
ㄱㅓ	거
ㄱㅓㄱ	걱
ㄱㅓㄲ	걲
ㄱㅓㄳ	걳
ㄱㅓㄴ	건
ㄱㅓㄵ	걵
ㄱㅓㄶ	걶
ㄱㅓㄷ	걷
ㄱㅓㄹ	걸
ㄱㅓㄺ	걹
ㄱㅓㄻ	걺
ㄱㅓㄼ	걻
ㄱㅓㄽ	걼
ㄱㅓㄾ	걽
ㄱㅓㄿ	걾
ㄱㅓㅀ	걿
ㄱㅓㅁ	검
ㄱㅓㅂ	겁
ㄱㅓㅄ	겂
ㄱㅓㅅ	것
ㄱㅓㅆ	겄
ㄱㅓㅇ	겅
ㄱㅓㅈ	겆
ㄱㅓㅊ	겇
ㄱㅓㅋ	겈
ㄱㅓㅌ	겉
ㄱㅓㅍ	겊
ㄱㅓㅎ	겋
ㄱㅔ	게
ㄱㅔㄱ	겍
ㄱㅔㄲ	겎
ㄱㅔㄳ	겏
ㄱㅔㄴ	겐
ㄱㅔㄵ	겑
ㄱㅔㄶ	겒
ㄱㅔㄷ	겓
ㄱㅔㄹ	겔
ㄱㅔㄺ	겕
ㄱㅔㄻ	겖
ㄱㅔㄼ	겗
ㄱㅔㄽ	겘
ㄱㅔㄾ	겙
ㄱㅔㄿ	겚
ㄱㅔㅀ	겛
ㄱㅔㅁ	겜
ㄱㅔㅂ	겝
ㄱㅔㅄ	겞
ㄱㅔㅅ	겟
ㄱㅔㅆ	겠
ㄱㅔㅇ	겡
ㄱㅔㅈ	겢
ㄱㅔㅊ	겣
ㄱㅔㅋ	겤
ㄱㅔㅌ	겥
ㄱㅔㅍ	겦
ㄱㅔㅎ	겧
ㄱㅕ	겨
ㄱㅕㄱ	격
ㄱㅕㄲ	겪
ㄱㅕㄳ	겫
ㄱㅕㄴ	견
ㄱㅕㄵ	겭
ㄱㅕㄶ	겮
ㄱㅕㄷ	겯
ㄱㅕㄹ	결
ㄱㅕㄺ	겱
ㄱㅕㄻ	겲
ㄱㅕㄼ	겳
ㄱㅕㄽ	겴
ㄱㅕㄾ	겵
ㄱㅕㄿ	겶
ㄱㅕㅀ	겷
ㄱㅕㅁ	겸
ㄱㅕㅂ	겹
ㄱㅕㅄ	겺
ㄱㅕㅅ	겻
ㄱㅕㅆ	겼
ㄱㅕㅇ	경
ㄱㅕㅈ	겾
ㄱㅕㅊ	겿
ㄱㅕㅋ	곀
ㄱㅕㅌ	곁
ㄱㅕㅍ	곂
ㄱㅕㅎ	곃
ㄱㅖ	계
ㄱㅖㄱ	곅
ㄱㅖㄲ	곆
ㄱㅖㄳ	곇
ㄱㅖㄴ	곈
ㄱㅖㄵ	곉
ㄱㅖㄶ	곊
ㄱㅖㄷ	곋
ㄱㅖㄹ	곌
ㄱㅖㄺ	곍
ㄱㅖㄻ	곎
ㄱㅖㄼ	곏
ㄱㅖㄽ	곐
ㄱㅖㄾ	곑
ㄱㅖㄿ	곒
ㄱㅖㅀ	곓
ㄱㅖㅁ	곔
ㄱㅖㅂ	곕
ㄱㅖㅄ	곖
ㄱㅖㅅ	곗
ㄱㅖㅆ	곘
ㄱㅖㅇ	곙
ㄱㅖㅈ	곚
ㄱㅖㅊ	곛
ㄱㅖㅋ	곜
ㄱㅖㅌ	곝
ㄱㅖㅍ	곞
ㄱㅖㅎ	곟
ㄱㅗ	고
ㄱㅗㄱ	곡
ㄱㅗㄲ	곢
ㄱㅗㄳ	곣
ㄱㅗㄴ	곤
ㄱㅗㄵ	곥
ㄱㅗㄶ	곦
ㄱㅗㄷ	곧
ㄱㅗㄹ	골
ㄱㅗㄺ	곩
ㄱㅗㄻ	곪
ㄱㅗㄼ	곫
ㄱㅗㄽ	곬
ㄱㅗㄾ	곭
ㄱㅗㄿ	곮
ㄱㅗㅀ	곯
ㄱㅗㅁ	곰
ㄱㅗㅂ	곱
ㄱㅗㅄ	곲
ㄱㅗㅅ	곳
ㄱㅗㅆ	곴
ㄱㅗㅇ	공
ㄱㅗㅈ	곶
ㄱㅗㅊ	곷
ㄱㅗㅋ	곸
ㄱㅗㅌ	곹
ㄱㅗㅍ	곺
ㄱㅗㅎ	곻
ㄱㅘ	과
ㄱㅘㄱ	곽
ㄱㅘㄲ	곾
ㄱㅘㄳ	곿
ㄱㅘㄴ	관
ㄱㅘㄵ	괁
ㄱㅘㄶ	괂
ㄱㅘㄷ	괃
ㄱㅘㄹ	괄
ㄱㅘㄺ	괅
ㄱㅘㄻ	괆
ㄱㅘㄼ	괇
ㄱㅘㄽ	괈
ㄱㅘㄾ	괉
ㄱㅘㄿ	괊
ㄱㅘㅀ	괋
ㄱㅘㅁ	괌
ㄱㅘㅂ	괍
ㄱㅘㅄ	괎
ㄱㅘㅅ	괏
ㄱㅘㅆ	괐
ㄱㅘㅇ	광
ㄱㅘㅈ	괒
ㄱㅘㅊ	괓
ㄱㅘㅋ	괔
ㄱㅘㅌ	괕
ㄱㅘㅍ	괖
ㄱㅘㅎ	괗
ㄱㅙ	괘
ㄱㅙㄱ	괙
ㄱㅙㄲ	괚
ㄱㅙㄳ	괛
ㄱㅙㄴ	괜
ㄱㅙㄵ	괝
ㄱㅙㄶ	괞
ㄱㅙㄷ	괟
ㄱㅙㄹ	괠
ㄱㅙㄺ	괡
ㄱㅙㄻ	괢
ㄱㅙㄼ	괣
ㄱㅙㄽ	괤
ㄱㅙㄾ	괥
ㄱㅙㄿ	괦
ㄱㅙㅀ	괧
ㄱㅙㅁ	괨
ㄱㅙㅂ	괩
ㄱㅙㅄ	괪
ㄱㅙㅅ	괫
ㄱㅙㅆ	괬
ㄱㅙㅇ	괭
ㄱㅙㅈ	괮
ㄱㅙㅊ	괯
ㄱㅙㅋ	괰
ㄱㅙㅌ	괱
ㄱㅙㅍ	괲
ㄱㅙㅎ	괳
ㄱㅚ	괴
ㄱㅚㄱ	괵
ㄱㅚㄲ	괶
ㄱㅚㄳ	괷
ㄱㅚㄴ	괸
ㄱㅚㄵ	괹
ㄱㅚㄶ	괺
ㄱㅚㄷ	괻
ㄱㅚㄹ	괼
ㄱㅚㄺ	괽
ㄱㅚㄻ	괾
ㄱㅚㄼ	괿
ㄱㅚㄽ	굀
ㄱㅚㄾ	굁
ㄱㅚㄿ	굂
ㄱㅚㅀ	굃
ㄱㅚㅁ	굄
ㄱㅚㅂ	굅
ㄱㅚㅄ	굆
ㄱㅚㅅ	굇
ㄱㅚㅆ	굈
ㄱㅚㅇ	굉
ㄱㅚㅈ	굊
ㄱㅚㅊ	굋
ㄱㅚㅋ	굌
ㄱㅚㅌ	굍
ㄱㅚㅍ	굎
ㄱㅚㅎ	굏
ㄱㅛ	교
ㄱㅛㄱ	굑
ㄱㅛㄲ	굒
ㄱㅛㄳ	굓
ㄱㅛㄴ	굔
ㄱㅛㄵ	굕
ㄱㅛㄶ	굖
ㄱㅛㄷ	굗
ㄱㅛㄹ	굘
ㄱㅛㄺ	굙
ㄱㅛㄻ	굚
ㄱㅛㄼ	굛
ㄱㅛㄽ	굜
ㄱㅛㄾ	굝
ㄱㅛㄿ	굞
ㄱㅛㅀ	굟
ㄱㅛㅁ	굠
ㄱㅛㅂ	굡
ㄱㅛㅄ	굢
ㄱㅛㅅ	굣
ㄱㅛㅆ	굤
ㄱㅛㅇ	굥
ㄱㅛㅈ	굦
ㄱㅛㅊ	굧
ㄱㅛㅋ	굨
ㄱㅛㅌ	굩
ㄱㅛㅍ	굪
ㄱㅛㅎ	굫
ㄱㅜ	구
ㄱㅜㄱ	국
ㄱㅜㄲ	굮
ㄱㅜㄳ	굯
ㄱㅜㄴ	군
ㄱㅜㄵ	굱
ㄱㅜㄶ	굲
ㄱㅜㄷ	굳
ㄱㅜㄹ	굴
ㄱㅜㄺ	굵
ㄱㅜㄻ	굶
ㄱㅜㄼ	굷
ㄱㅜㄽ	굸
ㄱㅜㄾ	굹
ㄱㅜㄿ	굺
ㄱㅜㅀ	굻
ㄱㅜㅁ	굼
ㄱㅜㅂ	굽
ㄱㅜㅄ	굾
ㄱㅜㅅ	굿
ㄱㅜㅆ	궀
ㄱㅜㅇ	궁
ㄱㅜㅈ	궂
ㄱㅜㅊ	궃
ㄱㅜㅋ	궄
ㄱㅜㅌ	궅
ㄱㅜㅍ	궆
ㄱㅜㅎ	궇
ㄱㅝ	궈
ㄱㅝㄱ	궉
ㄱㅝㄲ	궊
ㄱㅝㄳ	궋
ㄱㅝㄴ	권
ㄱㅝㄵ	궍
ㄱㅝㄶ	궎
ㄱㅝㄷ	궏
ㄱㅝㄹ	궐
ㄱㅝㄺ	궑
ㄱㅝㄻ	궒
ㄱㅝㄼ	궓
ㄱㅝㄽ	궔
ㄱㅝㄾ	궕
ㄱㅝㄿ	궖
ㄱㅝㅀ	궗
ㄱㅝㅁ	궘
ㄱㅝㅂ	궙
ㄱㅝㅄ	궚
ㄱㅝㅅ	궛
ㄱㅝㅆ	궜
ㄱㅝㅇ	궝
ㄱㅝㅈ	궞
ㄱㅝㅊ	궟
ㄱㅝㅋ	궠
ㄱㅝㅌ	궡
ㄱㅝㅍ	궢
ㄱㅝㅎ	궣
ㄱㅞ	궤
ㄱㅞㄱ	궥
ㄱㅞㄲ	궦
ㄱㅞㄳ	궧
ㄱㅞㄴ	궨
ㄱㅞㄵ	궩
ㄱㅞㄶ	궪
ㄱㅞㄷ	궫
ㄱㅞㄹ	궬
ㄱㅞㄺ	궭
ㄱㅞㄻ	궮
ㄱㅞㄼ	궯
ㄱㅞㄽ	궰
ㄱㅞㄾ	궱
ㄱㅞㄿ	궲
ㄱㅞㅀ	궳
ㄱㅞㅁ	궴
ㄱㅞㅂ	궵
ㄱㅞㅄ	궶
ㄱㅞㅅ	궷
ㄱㅞㅆ	궸
ㄱㅞㅇ	궹
ㄱㅞㅈ	궺
ㄱㅞㅊ	궻
ㄱㅞㅋ	궼
ㄱㅞㅌ	궽
ㄱㅞㅍ	궾
ㄱㅞㅎ	궿
ㄱㅟ	귀
ㄱㅟㄱ	귁
ㄱㅟㄲ	귂
ㄱㅟㄳ	귃
ㄱㅟㄴ	귄
ㄱㅟㄵ	귅
ㄱㅟㄶ	귆
ㄱㅟㄷ	귇
ㄱㅟㄹ	귈
ㄱㅟㄺ	귉
ㄱㅟㄻ	귊
ㄱㅟㄼ	귋
ㄱㅟㄽ	귌
ㄱㅟㄾ	귍
ㄱㅟㄿ	귎
ㄱㅟㅀ	귏
ㄱㅟㅁ	귐
ㄱㅟㅂ	귑
ㄱㅟㅄ	귒
ㄱㅟㅅ	귓
ㄱㅟㅆ	귔
ㄱㅟㅇ	귕
ㄱㅟㅈ	귖
ㄱㅟㅊ	귗
ㄱㅟㅋ	귘
ㄱㅟㅌ	귙
ㄱㅟㅍ	귚
ㄱㅟㅎ	귛
ㄱㅠ	규
ㄱㅠㄱ	귝
ㄱㅠㄲ	귞
ㄱㅠㄳ	귟
ㄱㅠㄴ	균
ㄱㅠㄵ	귡
ㄱㅠㄶ	귢
ㄱㅠㄷ	귣
ㄱㅠㄹ	귤
ㄱㅠㄺ	귥
ㄱㅠㄻ	귦
ㄱㅠㄼ	귧
ㄱㅠㄽ	귨
ㄱㅠㄾ	귩
ㄱㅠㄿ	귪
ㄱㅠㅀ	귫
ㄱㅠㅁ	귬
ㄱㅠㅂ	귭
ㄱㅠㅄ	귮
ㄱㅠㅅ	귯
ㄱㅠㅆ	귰
ㄱㅠㅇ	귱
ㄱㅠㅈ	귲
ㄱㅠㅊ	귳
ㄱㅠㅋ	귴
ㄱㅠㅌ	귵
ㄱㅠㅍ	귶
ㄱㅠㅎ	귷
ㄱㅡ	그
ㄱㅡㄱ	극
ㄱㅡㄲ	귺
ㄱㅡㄳ	귻
ㄱㅡㄴ	근
ㄱㅡㄵ	귽
ㄱㅡㄶ	귾
ㄱㅡㄷ	귿
ㄱㅡㄹ	글
ㄱㅡㄺ	긁
ㄱㅡㄻ	긂
ㄱㅡㄼ	긃
ㄱㅡㄽ	긄
ㄱㅡㄾ	긅
ㄱㅡㄿ	긆
ㄱㅡㅀ	긇
ㄱㅡㅁ	금
ㄱㅡㅂ	급
ㄱㅡㅄ	긊
ㄱㅡㅅ	긋
ㄱㅡㅆ	긌
ㄱㅡㅇ	긍
ㄱㅡㅈ	긎
ㄱㅡㅊ	긏
ㄱㅡㅋ	긐
ㄱㅡㅌ	긑
ㄱㅡㅍ	긒
ㄱㅡㅎ	긓
ㄱㅢ	긔
ㄱㅢㄱ	긕
ㄱㅢㄲ	긖
ㄱㅢㄳ	긗
ㄱㅢㄴ	긘
ㄱㅢㄵ	긙
ㄱㅢㄶ	긚
ㄱㅢㄷ	긛
ㄱㅢㄹ	긜
ㄱㅢㄺ	긝
ㄱㅢㄻ	긞
ㄱㅢㄼ	긟
ㄱㅢㄽ	긠
ㄱㅢㄾ	긡
ㄱㅢㄿ	긢
ㄱㅢㅀ	긣
ㄱㅢㅁ	긤
ㄱㅢㅂ	긥
ㄱㅢㅄ	긦
ㄱㅢㅅ	긧
ㄱㅢㅆ	긨
ㄱㅢㅇ	긩
ㄱㅢㅈ	긪
ㄱㅢㅊ	긫
ㄱㅢㅋ	긬
ㄱㅢㅌ	긭
ㄱㅢㅍ	긮
ㄱㅢㅎ	긯
ㄱㅣ	기
ㄱㅣㄱ	긱
ㄱㅣㄲ	긲
ㄱㅣㄳ	긳
ㄱㅣㄴ	긴
ㄱㅣㄵ	긵
ㄱㅣㄶ	긶
ㄱㅣㄷ	긷
ㄱㅣㄹ	길
ㄱㅣㄺ	긹
ㄱㅣㄻ	긺
ㄱㅣㄼ	긻
ㄱㅣㄽ	긼
ㄱㅣㄾ	긽
ㄱㅣㄿ	긾
ㄱㅣㅀ	긿
ㄱㅣㅁ	김
ㄱㅣㅂ	깁
ㄱㅣㅄ	깂
ㄱㅣㅅ	깃
ㄱㅣㅆ	깄
ㄱㅣㅇ	깅
ㄱㅣㅈ	깆
ㄱㅣㅊ	깇
ㄱㅣㅋ	깈
ㄱㅣㅌ	깉
ㄱㅣㅍ	깊
ㄱㅣㅎ	깋
ㄲㅏ	까
ㄲㅏㄱ	깍
ㄲㅏㄲ	깎
ㄲㅏㄳ	깏
ㄲㅏㄴ	깐
ㄲㅏㄵ	깑
ㄲㅏㄶ	깒
ㄲㅏㄷ	깓
ㄲㅏㄹ	깔
ㄲㅏㄺ	깕
ㄲㅏㄻ	깖
ㄲㅏㄼ	깗
ㄲㅏㄽ	깘
ㄲㅏㄾ	깙
ㄲㅏㄿ	깚
ㄲㅏㅀ	깛
ㄲㅏㅁ	깜
ㄲㅏㅂ	깝
ㄲㅏㅄ	깞
ㄲㅏㅅ	깟
ㄲㅏㅆ	깠
ㄲㅏㅇ	깡
ㄲㅏㅈ	깢
ㄲㅏㅊ	깣
ㄲㅏㅋ	깤
ㄲㅏㅌ	깥
ㄲㅏㅍ	깦
ㄲㅏㅎ	깧
ㄲㅐ	깨
ㄲㅐㄱ	깩
ㄲㅐㄲ	깪
ㄲㅐㄳ	깫
ㄲㅐㄴ	깬
ㄲㅐㄵ	깭
ㄲㅐㄶ	깮
ㄲㅐㄷ	깯
ㄲㅐㄹ	깰
ㄲㅐㄺ	깱
ㄲㅐㄻ	깲
ㄲㅐㄼ	깳
ㄲㅐㄽ	깴
ㄲㅐㄾ	깵
ㄲㅐㄿ	깶
ㄲㅐㅀ	깷
ㄲㅐㅁ	깸
ㄲㅐㅂ	깹
ㄲㅐㅄ	깺
ㄲㅐㅅ	깻
ㄲㅐㅆ	깼
ㄲㅐㅇ	깽
ㄲㅐㅈ	깾
ㄲㅐㅊ	깿
ㄲㅐㅋ	꺀
ㄲㅐㅌ	꺁
ㄲㅐㅍ	꺂
ㄲㅐㅎ	꺃
ㄲㅑ	꺄
ㄲㅑㄱ	꺅
ㄲㅑㄲ	꺆
ㄲㅑㄳ	꺇
ㄲㅑㄴ	꺈
ㄲㅑㄵ	꺉
ㄲㅑㄶ	꺊
ㄲㅑㄷ	꺋
ㄲㅑㄹ	꺌
ㄲㅑㄺ	꺍
ㄲㅑㄻ	꺎
ㄲㅑㄼ	꺏
ㄲㅑㄽ	꺐
ㄲㅑㄾ	꺑
ㄲㅑㄿ	꺒
ㄲㅑㅀ	꺓
ㄲㅑㅁ	꺔
ㄲㅑㅂ	꺕
ㄲㅑㅄ	꺖
ㄲㅑㅅ	꺗
ㄲㅑㅆ	꺘
ㄲㅑㅇ	꺙
ㄲㅑㅈ	꺚
ㄲㅑㅊ	꺛
ㄲㅑㅋ	꺜
ㄲㅑㅌ	꺝
ㄲㅑㅍ	꺞
ㄲㅑㅎ	꺟
ㄲㅒ	꺠
ㄲㅒㄱ	꺡
ㄲㅒㄲ	꺢
ㄲㅒㄳ	꺣
ㄲㅒㄴ	꺤
ㄲㅒㄵ	꺥
ㄲㅒㄶ	꺦
ㄲㅒㄷ	꺧
ㄲㅒㄹ	꺨
ㄲㅒㄺ	꺩
ㄲㅒㄻ	꺪
ㄲㅒㄼ	꺫
ㄲㅒㄽ	꺬
ㄲㅒㄾ	꺭
ㄲㅒㄿ	꺮
ㄲㅒㅀ	꺯
ㄲㅒㅁ	꺰
ㄲㅒㅂ	꺱
ㄲㅒㅄ	꺲
ㄲㅒㅅ	꺳
ㄲㅒㅆ	꺴
ㄲㅒㅇ	꺵
ㄲㅒㅈ	꺶
ㄲㅒㅊ	꺷
ㄲㅒㅋ	꺸
ㄲㅒㅌ	꺹
ㄲㅒㅍ	꺺
ㄲㅒㅎ	꺻
ㄲㅓ	꺼
ㄲㅓㄱ	꺽
ㄲㅓㄲ	꺾
ㄲㅓㄳ	꺿
ㄲㅓㄴ	껀
ㄲㅓㄵ	껁
ㄲㅓㄶ	껂
ㄲㅓㄷ	껃
ㄲㅓㄹ	껄
ㄲㅓㄺ	껅
ㄲㅓㄻ	껆
ㄲㅓㄼ	껇
ㄲㅓㄽ	껈
ㄲㅓㄾ	껉
ㄲㅓㄿ	껊
ㄲㅓㅀ	껋
ㄲㅓㅁ	껌
ㄲㅓㅂ	껍
ㄲㅓㅄ	껎
ㄲㅓㅅ	껏
ㄲㅓㅆ	껐
ㄲㅓㅇ	껑
ㄲㅓㅈ	껒
ㄲㅓㅊ	껓
ㄲㅓㅋ	껔
ㄲㅓㅌ	껕
ㄲㅓㅍ	껖
ㄲㅓㅎ	껗
ㄲㅔ	께
ㄲㅔㄱ	껙
ㄲㅔㄲ	껚
ㄲㅔㄳ	껛
ㄲㅔㄴ	껜
ㄲㅔㄵ	껝
ㄲㅔㄶ	껞
ㄲㅔㄷ	껟
ㄲㅔㄹ	껠
ㄲㅔㄺ	껡
ㄲㅔㄻ	껢
ㄲㅔㄼ	껣
ㄲㅔㄽ	껤
ㄲㅔㄾ	껥
ㄲㅔㄿ	껦
ㄲㅔㅀ	껧
ㄲㅔㅁ	껨
ㄲㅔㅂ	껩
ㄲㅔㅄ	껪
ㄲㅔㅅ	껫
ㄲㅔㅆ	껬
ㄲㅔㅇ	껭
ㄲㅔㅈ	껮
ㄲㅔㅊ	껯
ㄲㅔㅋ	껰
ㄲㅔㅌ	껱
ㄲㅔㅍ	껲
ㄲㅔㅎ	껳
ㄲㅕ	껴
ㄲㅕㄱ	껵
ㄲㅕㄲ	껶
ㄲㅕㄳ	껷
ㄲㅕㄴ	껸
ㄲㅕㄵ	껹
ㄲㅕㄶ	껺
ㄲㅕㄷ	껻
ㄲㅕㄹ	껼
ㄲㅕㄺ	껽
ㄲㅕㄻ	껾
ㄲㅕㄼ	껿
ㄲㅕㄽ	꼀
ㄲㅕㄾ	꼁
ㄲㅕㄿ	꼂
ㄲㅕㅀ	꼃
ㄲㅕㅁ	꼄
ㄲㅕㅂ	꼅
ㄲㅕㅄ	꼆
ㄲㅕㅅ	꼇
ㄲㅕㅆ	꼈
ㄲㅕㅇ	꼉
ㄲㅕㅈ	꼊
ㄲㅕㅊ	꼋
ㄲㅕㅋ	꼌
ㄲㅕㅌ	꼍
ㄲㅕㅍ	꼎
ㄲㅕㅎ	꼏
ㄲㅖ	꼐
ㄲㅖㄱ	꼑
ㄲㅖㄲ	꼒
ㄲㅖㄳ	꼓
ㄲㅖㄴ	꼔
ㄲㅖㄵ	꼕
ㄲㅖㄶ	꼖
ㄲㅖㄷ	꼗
ㄲㅖㄹ	꼘
ㄲㅖㄺ	꼙
ㄲㅖㄻ	꼚
ㄲㅖㄼ	꼛
ㄲㅖㄽ	꼜
ㄲㅖㄾ	꼝
ㄲㅖㄿ	꼞
ㄲㅖㅀ	꼟
ㄲㅖㅁ	꼠
ㄲㅖㅂ	꼡
ㄲㅖㅄ	꼢
ㄲㅖㅅ	꼣
ㄲㅖㅆ	꼤
ㄲㅖㅇ	꼥
ㄲㅖㅈ	꼦
ㄲㅖㅊ	꼧
ㄲㅖㅋ	꼨
ㄲㅖㅌ	꼩
ㄲㅖㅍ	꼪
ㄲㅖㅎ	꼫
ㄲㅗ	꼬
ㄲㅗㄱ	꼭
ㄲㅗㄲ	꼮
ㄲㅗㄳ	꼯
ㄲㅗㄴ	꼰
ㄲㅗㄵ	꼱
ㄲㅗㄶ	꼲
ㄲㅗㄷ	꼳
ㄲㅗㄹ	꼴
ㄲㅗㄺ	꼵
ㄲㅗㄻ	꼶
ㄲㅗㄼ	꼷
ㄲㅗㄽ	꼸
ㄲㅗㄾ	꼹
ㄲㅗㄿ	꼺
ㄲㅗㅀ	꼻
ㄲㅗㅁ	꼼
ㄲㅗㅂ	꼽
ㄲㅗㅄ	꼾
ㄲㅗㅅ	꼿
ㄲㅗㅆ	꽀
ㄲㅗㅇ	꽁
ㄲㅗㅈ	꽂
ㄲㅗㅊ	꽃
ㄲㅗㅋ	꽄
ㄲㅗㅌ	꽅
ㄲㅗㅍ	꽆
ㄲㅗㅎ	꽇
ㄲㅘ	꽈
ㄲㅘㄱ	꽉
ㄲㅘㄲ	꽊
ㄲㅘㄳ	꽋
ㄲㅘㄴ	꽌
ㄲㅘㄵ	꽍
ㄲㅘㄶ	꽎
ㄲㅘㄷ	꽏
ㄲㅘㄹ	꽐
ㄲㅘㄺ	꽑
ㄲㅘㄻ	꽒
ㄲㅘㄼ	꽓
ㄲㅘㄽ	꽔
ㄲㅘㄾ	꽕
ㄲㅘㄿ	꽖
ㄲㅘㅀ	꽗
ㄲㅘㅁ	꽘
ㄲㅘㅂ	꽙
ㄲㅘㅄ	꽚
ㄲㅘㅅ	꽛
ㄲㅘㅆ	꽜
ㄲㅘㅇ	꽝
ㄲㅘㅈ	꽞
ㄲㅘㅊ	꽟
ㄲㅘㅋ	꽠
ㄲㅘㅌ	꽡
ㄲㅘㅍ	꽢
ㄲㅘㅎ	꽣
ㄲㅙ	꽤
ㄲㅙㄱ	꽥
ㄲㅙㄲ	꽦
ㄲㅙㄳ	꽧
ㄲㅙㄴ	꽨
ㄲㅙㄵ	꽩
ㄲㅙㄶ	꽪
ㄲㅙㄷ	꽫
ㄲㅙㄹ	꽬
ㄲㅙㄺ	꽭
ㄲㅙㄻ	꽮
ㄲㅙㄼ	꽯
ㄲㅙㄽ	꽰
ㄲㅙㄾ	꽱
ㄲㅙㄿ	꽲
ㄲㅙㅀ	꽳
ㄲㅙㅁ	꽴
ㄲㅙㅂ	꽵
ㄲㅙㅄ	꽶
ㄲㅙㅅ	꽷
ㄲㅙㅆ	꽸
ㄲㅙㅇ	꽹
ㄲㅙㅈ	꽺
ㄲㅙㅊ	꽻
ㄲㅙㅋ	꽼
ㄲㅙㅌ	꽽
ㄲㅙㅍ	꽾
ㄲㅙㅎ	꽿
ㄲㅚ	꾀
ㄲㅚㄱ	꾁
ㄲㅚㄲ	꾂
ㄲㅚㄳ	꾃
ㄲㅚㄴ	꾄
ㄲㅚㄵ	꾅
ㄲㅚㄶ	꾆
ㄲㅚㄷ	꾇
ㄲㅚㄹ	꾈
ㄲㅚㄺ	꾉
ㄲㅚㄻ	꾊
ㄲㅚㄼ	꾋
ㄲㅚㄽ	꾌
ㄲㅚㄾ	꾍
ㄲㅚㄿ	꾎
ㄲㅚㅀ	꾏
ㄲㅚㅁ	꾐
ㄲㅚㅂ	꾑
ㄲㅚㅄ	꾒
ㄲㅚㅅ	꾓
ㄲㅚㅆ	꾔
ㄲㅚㅇ	꾕
ㄲㅚㅈ	꾖
ㄲㅚㅊ	꾗
ㄲㅚㅋ	꾘
ㄲㅚㅌ	꾙
ㄲㅚㅍ	꾚
ㄲㅚㅎ	꾛
ㄲㅛ	꾜
ㄲㅛㄱ	꾝
ㄲㅛㄲ	꾞
ㄲㅛㄳ	꾟
ㄲㅛㄴ	꾠
ㄲㅛㄵ	꾡
ㄲㅛㄶ	꾢
ㄲㅛㄷ	꾣
ㄲㅛㄹ	꾤
ㄲㅛㄺ	꾥
ㄲㅛㄻ	꾦
ㄲㅛㄼ	꾧
ㄲㅛㄽ	꾨
ㄲㅛㄾ	꾩
ㄲㅛㄿ	꾪
ㄲㅛㅀ	꾫
ㄲㅛㅁ	꾬
ㄲㅛㅂ	꾭
ㄲㅛㅄ	꾮
ㄲㅛㅅ	꾯
ㄲㅛㅆ	꾰
ㄲㅛㅇ	꾱
ㄲㅛㅈ	꾲
ㄲㅛㅊ	꾳
ㄲㅛㅋ	꾴
ㄲㅛㅌ	꾵
ㄲㅛㅍ	꾶
ㄲㅛㅎ	꾷
ㄲㅜ	꾸
ㄲㅜㄱ	꾹
ㄲㅜㄲ	꾺
ㄲㅜㄳ	꾻
ㄲㅜㄴ	꾼
ㄲㅜㄵ	꾽
ㄲㅜㄶ	꾾
ㄲㅜㄷ	꾿
ㄲㅜㄹ	꿀
ㄲㅜㄺ	꿁
ㄲㅜㄻ	꿂
ㄲㅜㄼ	꿃
ㄲㅜㄽ	꿄
ㄲㅜㄾ	꿅
ㄲㅜㄿ	꿆
ㄲㅜㅀ	꿇
ㄲㅜㅁ	꿈
ㄲㅜㅂ	꿉
ㄲㅜㅄ	꿊
ㄲㅜㅅ	꿋
ㄲㅜㅆ	꿌
ㄲㅜㅇ	꿍
ㄲㅜㅈ	꿎
ㄲㅜㅊ	꿏
ㄲㅜㅋ	꿐
ㄲㅜㅌ	꿑
ㄲㅜㅍ	꿒
ㄲㅜㅎ	꿓
ㄲㅝ	꿔
ㄲㅝㄱ	꿕
ㄲㅝㄲ	꿖
ㄲㅝㄳ	꿗
ㄲㅝㄴ	꿘
ㄲㅝㄵ	꿙
ㄲㅝㄶ	꿚
ㄲㅝㄷ	꿛
ㄲㅝㄹ	꿜
ㄲㅝㄺ	꿝
ㄲㅝㄻ	꿞
ㄲㅝㄼ	꿟
ㄲㅝㄽ	꿠
ㄲㅝㄾ	꿡
ㄲㅝㄿ	꿢
ㄲㅝㅀ	꿣
ㄲㅝㅁ	꿤
ㄲㅝㅂ	꿥
ㄲㅝㅄ	꿦
ㄲㅝㅅ	꿧
ㄲㅝㅆ	꿨
ㄲㅝㅇ	꿩
ㄲㅝㅈ	꿪
ㄲㅝㅊ	꿫
ㄲㅝㅋ	꿬
ㄲㅝㅌ	꿭
ㄲㅝㅍ	꿮
ㄲㅝㅎ	꿯
ㄲㅞ	꿰
ㄲㅞㄱ	꿱
ㄲㅞㄲ	꿲
ㄲㅞㄳ	꿳
ㄲㅞㄴ	꿴
ㄲㅞㄵ	꿵
ㄲㅞㄶ	꿶
ㄲㅞㄷ	꿷
ㄲㅞㄹ	꿸
ㄲㅞㄺ	꿹
ㄲㅞㄻ	꿺
ㄲㅞㄼ	꿻
ㄲㅞㄽ	꿼
ㄲㅞㄾ	꿽
ㄲㅞㄿ	꿾
ㄲㅞㅀ	꿿
ㄲㅞㅁ	뀀
ㄲㅞㅂ	뀁
ㄲㅞㅄ	뀂
ㄲㅞㅅ	뀃
ㄲㅞㅆ	뀄
ㄲㅞㅇ	뀅
ㄲㅞㅈ	뀆
ㄲㅞㅊ	뀇
ㄲㅞㅋ	뀈
ㄲㅞㅌ	뀉
ㄲㅞㅍ	뀊
ㄲㅞㅎ	뀋
ㄲㅟ	뀌
ㄲㅟㄱ	뀍
ㄲㅟㄲ	뀎
ㄲㅟㄳ	뀏
ㄲㅟㄴ	뀐
ㄲㅟㄵ	뀑
ㄲㅟㄶ	뀒
ㄲㅟㄷ	뀓
ㄲㅟㄹ	뀔
ㄲㅟㄺ	뀕
ㄲㅟㄻ	뀖
ㄲㅟㄼ	뀗
ㄲㅟㄽ	뀘
ㄲㅟㄾ	뀙
ㄲㅟㄿ	뀚
ㄲㅟㅀ	뀛
ㄲㅟㅁ	뀜
ㄲㅟㅂ	뀝
ㄲㅟㅄ	뀞
ㄲㅟㅅ	뀟
ㄲㅟㅆ	뀠
ㄲㅟㅇ	뀡
ㄲㅟㅈ	뀢
ㄲㅟㅊ	뀣
ㄲㅟㅋ	뀤
ㄲㅟㅌ	뀥
ㄲㅟㅍ	뀦
ㄲㅟㅎ	뀧
ㄲㅠ	뀨
ㄲㅠㄱ	뀩
ㄲㅠㄲ	뀪
ㄲㅠㄳ	뀫
ㄲㅠㄴ	뀬
ㄲㅠㄵ	뀭
ㄲㅠㄶ	뀮
ㄲㅠㄷ	뀯
ㄲㅠㄹ	뀰
ㄲㅠㄺ	뀱
ㄲㅠㄻ	뀲
ㄲㅠㄼ	뀳
ㄲㅠㄽ	뀴
ㄲㅠㄾ	뀵
ㄲㅠㄿ	뀶
ㄲㅠㅀ	뀷
ㄲㅠㅁ	뀸
ㄲㅠㅂ	뀹
ㄲㅠㅄ	뀺
ㄲㅠㅅ	뀻
ㄲㅠㅆ	뀼
ㄲㅠㅇ	뀽
ㄲㅠㅈ	뀾
ㄲㅠㅊ	뀿
ㄲㅠㅋ	끀
ㄲㅠㅌ	끁
ㄲㅠㅍ	끂
ㄲㅠㅎ	끃
ㄲㅡ	끄
ㄲㅡㄱ	끅
ㄲㅡㄲ	끆
ㄲㅡㄳ	끇
ㄲㅡㄴ	끈
ㄲㅡㄵ	끉
ㄲㅡㄶ	끊
ㄲㅡㄷ	끋
ㄲㅡㄹ	끌
ㄲㅡㄺ	끍
ㄲㅡㄻ	끎
ㄲㅡㄼ	끏
ㄲㅡㄽ	끐
ㄲㅡㄾ	끑
ㄲㅡㄿ	끒
ㄲㅡㅀ	끓
ㄲㅡㅁ	끔
ㄲㅡㅂ	끕
ㄲㅡㅄ	끖
ㄲㅡㅅ	끗
ㄲㅡㅆ	끘
ㄲㅡㅇ	끙
ㄲㅡㅈ	끚
ㄲㅡㅊ	끛
ㄲㅡㅋ	끜
ㄲㅡㅌ	끝
ㄲㅡㅍ	끞
ㄲㅡㅎ	끟
ㄲㅢ	끠
ㄲㅢㄱ	끡
ㄲㅢㄲ	끢
ㄲㅢㄳ	끣
ㄲㅢㄴ	끤
ㄲㅢㄵ	끥
ㄲㅢㄶ	끦
ㄲㅢㄷ	끧
ㄲㅢㄹ	끨
ㄲㅢㄺ	끩
ㄲㅢㄻ	끪
ㄲㅢㄼ	끫
ㄲㅢㄽ	끬
ㄲㅢㄾ	끭
ㄲㅢㄿ	끮
ㄲㅢㅀ	끯
ㄲㅢㅁ	끰
ㄲㅢㅂ	끱
ㄲㅢㅄ	끲
ㄲㅢㅅ	끳
ㄲㅢㅆ	끴
ㄲㅢㅇ	끵
ㄲㅢㅈ	끶
ㄲㅢㅊ	끷
ㄲㅢㅋ	끸
ㄲㅢㅌ	끹
ㄲㅢㅍ	끺
ㄲㅢㅎ	끻
ㄲㅣ	끼
ㄲㅣㄱ	끽
ㄲㅣㄲ	끾
ㄲㅣㄳ	끿
ㄲㅣㄴ	낀
ㄲㅣㄵ	낁
ㄲㅣㄶ	낂
ㄲㅣㄷ	낃
ㄲㅣㄹ	낄
ㄲㅣㄺ	낅
ㄲㅣㄻ	낆
ㄲㅣㄼ	낇
ㄲㅣㄽ	낈
ㄲㅣㄾ	낉
ㄲㅣㄿ	낊
ㄲㅣㅀ	낋
ㄲㅣㅁ	낌
ㄲㅣㅂ	낍
ㄲㅣㅄ	낎
ㄲㅣㅅ	낏
ㄲㅣㅆ	낐
ㄲㅣㅇ	낑
ㄲㅣㅈ	낒
ㄲㅣㅊ	낓
ㄲㅣㅋ	낔
ㄲㅣㅌ	낕
ㄲㅣㅍ	낖
ㄲㅣㅎ	낗
ㄴㅏ	나
ㄴㅏㄱ	낙
ㄴㅏㄲ	낚
ㄴㅏㄳ	낛
ㄴㅏㄴ	난
ㄴㅏㄵ	낝
ㄴㅏㄶ	낞
ㄴㅏㄷ	낟
ㄴㅏㄹ	날
ㄴㅏㄺ	낡
ㄴㅏㄻ	낢
ㄴㅏㄼ	낣
ㄴㅏㄽ	낤
ㄴㅏㄾ	낥
ㄴㅏㄿ	낦
ㄴㅏㅀ	낧
ㄴㅏㅁ	남
ㄴㅏㅂ	납
ㄴㅏㅄ	낪
ㄴㅏㅅ	낫
ㄴㅏㅆ	났
ㄴㅏㅇ	낭
ㄴㅏㅈ	낮
ㄴㅏㅊ	낯
ㄴㅏㅋ	낰
ㄴㅏㅌ	낱
ㄴㅏㅍ	낲
ㄴㅏㅎ	낳
ㄴㅐ	내
ㄴㅐㄱ	낵
ㄴㅐㄲ	낶
ㄴㅐㄳ	낷
ㄴㅐㄴ	낸
ㄴㅐㄵ	낹
ㄴㅐㄶ	낺
ㄴㅐㄷ	낻
ㄴㅐㄹ	낼
ㄴㅐㄺ	낽
ㄴㅐㄻ	낾
ㄴㅐㄼ	낿
ㄴㅐㄽ	냀
ㄴㅐㄾ	냁
ㄴㅐㄿ	냂
ㄴㅐㅀ	냃
ㄴㅐㅁ	냄
ㄴㅐㅂ	냅
ㄴㅐㅄ	냆
ㄴㅐㅅ	냇
ㄴㅐㅆ	냈
ㄴㅐㅇ	냉
ㄴㅐㅈ	냊
ㄴㅐㅊ	냋
ㄴㅐㅋ	냌
ㄴㅐㅌ	냍
ㄴㅐㅍ	냎
ㄴㅐㅎ	냏
ㄴㅑ	냐
ㄴㅑㄱ	냑
ㄴㅑㄲ	냒
ㄴㅑㄳ	냓
ㄴㅑㄴ	냔
ㄴㅑㄵ	냕
ㄴㅑㄶ	냖
ㄴㅑㄷ	냗
ㄴㅑㄹ	냘
ㄴㅑㄺ	냙
ㄴㅑㄻ	냚
ㄴㅑㄼ	냛
ㄴㅑㄽ	냜
ㄴㅑㄾ	냝
ㄴㅑㄿ	냞
ㄴㅑㅀ	냟
ㄴㅑㅁ	냠
ㄴㅑㅂ	냡
ㄴㅑㅄ	냢
ㄴㅑㅅ	냣
ㄴㅑㅆ	냤
ㄴㅑㅇ	냥
ㄴㅑㅈ	냦
ㄴㅑㅊ	냧
ㄴㅑㅋ	냨
ㄴㅑㅌ	냩
ㄴㅑㅍ	냪
ㄴㅑㅎ	냫
ㄴㅒ	냬
ㄴㅒㄱ	냭
ㄴㅒㄲ	냮
ㄴㅒㄳ	냯
ㄴㅒㄴ	냰
ㄴㅒㄵ	냱
ㄴㅒㄶ	냲
ㄴㅒㄷ	냳
ㄴㅒㄹ	냴
ㄴㅒㄺ	냵
ㄴㅒㄻ	냶
ㄴㅒㄼ	냷
ㄴㅒㄽ	냸
ㄴㅒㄾ	냹
ㄴㅒㄿ	냺
ㄴㅒㅀ	냻
ㄴㅒㅁ	냼
ㄴㅒㅂ	냽
ㄴㅒㅄ	냾
ㄴㅒㅅ	냿
ㄴㅒㅆ	넀
ㄴㅒㅇ	넁
ㄴㅒㅈ	넂
ㄴㅒㅊ	넃
ㄴㅒㅋ	넄
ㄴㅒㅌ	넅
ㄴㅒㅍ	넆
ㄴㅒㅎ	넇
ㄴㅓ	너
ㄴㅓㄱ	넉
ㄴㅓㄲ	넊
ㄴㅓㄳ	넋
ㄴㅓㄴ	넌
ㄴㅓㄵ	넍
ㄴㅓㄶ	넎
ㄴㅓㄷ	넏
ㄴㅓㄹ	널
ㄴㅓㄺ	넑
ㄴㅓㄻ	넒
ㄴㅓㄼ	넓
ㄴㅓㄽ	넔
ㄴㅓㄾ	넕
ㄴㅓㄿ	넖
ㄴㅓㅀ	넗
ㄴㅓㅁ	넘
ㄴㅓㅂ	넙
ㄴㅓㅄ	넚
ㄴㅓㅅ	넛
ㄴㅓㅆ	넜
ㄴㅓㅇ	넝
ㄴㅓㅈ	넞
ㄴㅓㅊ	넟
ㄴㅓㅋ	넠
ㄴㅓㅌ	넡
ㄴㅓㅍ	넢
ㄴㅓㅎ	넣
ㄴㅔ	네
ㄴㅔㄱ	넥
ㄴㅔㄲ	넦
ㄴㅔㄳ	넧
ㄴㅔㄴ	넨
ㄴㅔㄵ	넩
ㄴㅔㄶ	넪
ㄴㅔㄷ	넫
ㄴㅔㄹ	넬
ㄴㅔㄺ	넭
ㄴㅔㄻ	넮
ㄴㅔㄼ	넯
ㄴㅔㄽ	넰
ㄴㅔㄾ	넱
ㄴㅔㄿ	넲
ㄴㅔㅀ	넳
ㄴㅔㅁ	넴
ㄴㅔㅂ	넵
ㄴㅔㅄ	넶
ㄴㅔㅅ	넷
ㄴㅔㅆ	넸
ㄴㅔㅇ	넹
ㄴㅔㅈ	넺
ㄴㅔㅊ	넻
ㄴㅔㅋ	넼
ㄴㅔㅌ	넽
ㄴㅔㅍ	넾
ㄴㅔㅎ	넿
ㄴㅕ	녀
ㄴㅕㄱ	녁
ㄴㅕㄲ	녂
ㄴㅕㄳ	녃
ㄴㅕㄴ	년
ㄴㅕㄵ	녅
ㄴㅕㄶ	녆
ㄴㅕㄷ	녇
ㄴㅕㄹ	녈
ㄴㅕㄺ	녉
ㄴㅕㄻ	녊
ㄴㅕㄼ	녋
ㄴㅕㄽ	녌
ㄴㅕㄾ	녍
ㄴㅕㄿ	녎
ㄴㅕㅀ	녏
ㄴㅕㅁ	념
ㄴㅕㅂ	녑
ㄴㅕㅄ	녒
ㄴㅕㅅ	녓
ㄴㅕㅆ	녔
ㄴㅕㅇ	녕
ㄴㅕㅈ	녖
ㄴㅕㅊ	녗
ㄴㅕㅋ	녘
ㄴㅕㅌ	녙
ㄴㅕㅍ	녚
ㄴㅕㅎ	녛
ㄴㅖ	녜
ㄴㅖㄱ	녝
ㄴㅖㄲ	녞
ㄴㅖㄳ	녟
ㄴㅖㄴ	녠
ㄴㅖㄵ	녡
ㄴㅖㄶ	녢
ㄴㅖㄷ	녣
ㄴㅖㄹ	녤
ㄴㅖㄺ	녥
ㄴㅖㄻ	녦
ㄴㅖㄼ	녧
ㄴㅖㄽ	녨
ㄴㅖㄾ	녩
ㄴㅖㄿ	녪
ㄴㅖㅀ	녫
ㄴㅖㅁ	녬
ㄴㅖㅂ	녭
ㄴㅖㅄ	녮
ㄴㅖㅅ	녯
ㄴㅖㅆ	녰
ㄴㅖㅇ	녱
ㄴㅖㅈ	녲
ㄴㅖㅊ	녳
ㄴㅖㅋ	녴
ㄴㅖㅌ	녵
ㄴㅖㅍ	녶
ㄴㅖㅎ	녷
ㄴㅗ	노
ㄴㅗㄱ	녹
ㄴㅗㄲ	녺
ㄴㅗㄳ	녻
ㄴㅗㄴ	논
ㄴㅗㄵ	녽
ㄴㅗㄶ	녾
ㄴㅗㄷ	녿
ㄴㅗㄹ	놀
ㄴㅗㄺ	놁
ㄴㅗㄻ	놂
ㄴㅗㄼ	놃
ㄴㅗㄽ	놄
ㄴㅗㄾ	놅
ㄴㅗㄿ	놆
ㄴㅗㅀ	놇
ㄴㅗㅁ	놈
ㄴㅗㅂ	놉
ㄴㅗㅄ	놊
ㄴㅗㅅ	놋
ㄴㅗㅆ	놌
ㄴㅗㅇ	농
ㄴㅗㅈ	놎
ㄴㅗㅊ	놏
ㄴㅗㅋ	놐
ㄴㅗㅌ	놑
ㄴㅗㅍ	높
ㄴㅗㅎ	놓
ㄴㅘ	놔
ㄴㅘㄱ	놕
ㄴㅘㄲ	놖
ㄴㅘㄳ	놗
ㄴㅘㄴ	놘
ㄴㅘㄵ	놙
ㄴㅘㄶ	놚
ㄴㅘㄷ	놛
ㄴㅘㄹ	놜
ㄴㅘㄺ	놝
ㄴㅘㄻ	놞
ㄴㅘㄼ	놟
ㄴㅘㄽ	놠
ㄴㅘㄾ	놡
ㄴㅘㄿ	놢
ㄴㅘㅀ	놣
ㄴㅘㅁ	놤
ㄴㅘㅂ	놥
ㄴㅘㅄ	놦
ㄴㅘㅅ	놧
ㄴㅘㅆ	놨
ㄴㅘㅇ	놩
ㄴㅘㅈ	놪
ㄴㅘㅊ	놫
ㄴㅘㅋ	놬
ㄴㅘㅌ	놭
ㄴㅘㅍ	놮
ㄴㅘㅎ	놯
ㄴㅙ	놰
ㄴㅙㄱ	놱
ㄴㅙㄲ	놲
ㄴㅙㄳ	놳
ㄴㅙㄴ	놴
ㄴㅙㄵ	놵
ㄴㅙㄶ	놶
ㄴㅙㄷ	놷
ㄴㅙㄹ	놸
ㄴㅙㄺ	놹
ㄴㅙㄻ	놺
ㄴㅙㄼ	놻
ㄴㅙㄽ	놼
ㄴㅙㄾ	놽
ㄴㅙㄿ	놾
ㄴㅙㅀ	놿
ㄴㅙㅁ	뇀
ㄴㅙㅂ	뇁
ㄴㅙㅄ	뇂
ㄴㅙㅅ	뇃
ㄴㅙㅆ	뇄
ㄴㅙㅇ	뇅
ㄴㅙㅈ	뇆
ㄴㅙㅊ	뇇
ㄴㅙㅋ	뇈
ㄴㅙㅌ	뇉
ㄴㅙㅍ	뇊
ㄴㅙㅎ	뇋
ㄴㅚ	뇌
ㄴㅚㄱ	뇍
ㄴㅚㄲ	뇎
ㄴㅚㄳ	뇏
ㄴㅚㄴ	뇐
ㄴㅚㄵ	뇑
ㄴㅚㄶ	뇒
ㄴㅚㄷ	뇓
ㄴㅚㄹ	뇔
ㄴㅚㄺ	뇕
ㄴㅚㄻ	뇖
ㄴㅚㄼ	뇗
ㄴㅚㄽ	뇘
ㄴㅚㄾ	뇙
ㄴㅚㄿ	뇚
ㄴㅚㅀ	뇛
ㄴㅚㅁ	뇜
ㄴㅚㅂ	뇝
ㄴㅚㅄ	뇞
ㄴㅚㅅ	뇟
ㄴㅚㅆ	뇠
ㄴㅚㅇ	뇡
ㄴㅚㅈ	뇢
ㄴㅚㅊ	뇣
ㄴㅚㅋ	뇤
ㄴㅚㅌ	뇥
ㄴㅚㅍ	뇦
ㄴㅚㅎ	뇧
ㄴㅛ	뇨
ㄴㅛㄱ	뇩
ㄴㅛㄲ	뇪
ㄴㅛㄳ	뇫
ㄴㅛㄴ	뇬
ㄴㅛㄵ	뇭
ㄴㅛㄶ	뇮
ㄴㅛㄷ	뇯
ㄴㅛㄹ	뇰
ㄴㅛㄺ	뇱
ㄴㅛㄻ	뇲
ㄴㅛㄼ	뇳
ㄴㅛㄽ	뇴
ㄴㅛㄾ	뇵
ㄴㅛㄿ	뇶
ㄴㅛㅀ	뇷
ㄴㅛㅁ	뇸
ㄴㅛㅂ	뇹
ㄴㅛㅄ	뇺
ㄴㅛㅅ	뇻
ㄴㅛㅆ	뇼
ㄴㅛㅇ	뇽
ㄴㅛㅈ	뇾
ㄴㅛㅊ	뇿
ㄴㅛㅋ	눀
ㄴㅛㅌ	눁
ㄴㅛㅍ	눂
ㄴㅛㅎ	눃
ㄴㅜ	누
ㄴㅜㄱ	눅
ㄴㅜㄲ	눆
ㄴㅜㄳ	눇
ㄴㅜㄴ	눈
ㄴㅜㄵ	눉
ㄴㅜㄶ	눊
ㄴㅜㄷ	눋
ㄴㅜㄹ	눌
ㄴㅜㄺ	눍
ㄴㅜㄻ	눎
ㄴㅜㄼ	눏
ㄴㅜㄽ	눐
ㄴㅜㄾ	눑
ㄴㅜㄿ	눒
ㄴㅜㅀ	눓
ㄴㅜㅁ	눔
ㄴㅜㅂ	눕
ㄴㅜㅄ	눖
ㄴㅜㅅ	눗
ㄴㅜㅆ	눘
ㄴㅜㅇ	눙
ㄴㅜㅈ	눚
ㄴㅜㅊ	눛
ㄴㅜㅋ	눜
ㄴㅜㅌ	눝
ㄴㅜㅍ	눞
ㄴㅜㅎ	눟
ㄴㅝ	눠
ㄴㅝㄱ	눡
ㄴㅝㄲ	눢
ㄴㅝㄳ	눣
ㄴㅝㄴ	눤
ㄴㅝㄵ	눥
ㄴㅝㄶ	눦
ㄴㅝㄷ	눧
ㄴㅝㄹ	눨
ㄴㅝㄺ	눩
ㄴㅝㄻ	눪
ㄴㅝㄼ	눫
ㄴㅝㄽ	눬
ㄴㅝㄾ	눭
ㄴㅝㄿ	눮
ㄴㅝㅀ	눯
ㄴㅝㅁ	눰
ㄴㅝㅂ	눱
ㄴㅝㅄ	눲
ㄴㅝㅅ	눳
ㄴㅝㅆ	눴
ㄴㅝㅇ	눵
ㄴㅝㅈ	눶
ㄴㅝㅊ	눷
ㄴㅝㅋ	눸
ㄴㅝㅌ	눹
ㄴㅝㅍ	눺
ㄴㅝㅎ	눻
ㄴㅞ	눼
ㄴㅞㄱ	눽
ㄴㅞㄲ	눾
ㄴㅞㄳ	눿
ㄴㅞㄴ	뉀
ㄴㅞㄵ	뉁
ㄴㅞㄶ	뉂
ㄴㅞㄷ	뉃
ㄴㅞㄹ	뉄
ㄴㅞㄺ	뉅
ㄴㅞㄻ	뉆
ㄴㅞㄼ	뉇
ㄴㅞㄽ	뉈
ㄴㅞㄾ	뉉
ㄴㅞㄿ	뉊
ㄴㅞㅀ	뉋
ㄴㅞㅁ	뉌
ㄴㅞㅂ	뉍
ㄴㅞㅄ	뉎
ㄴㅞㅅ	뉏
ㄴㅞㅆ	뉐
ㄴㅞㅇ	뉑
ㄴㅞㅈ	뉒
ㄴㅞㅊ	뉓
ㄴㅞㅋ	뉔
ㄴㅞㅌ	뉕
ㄴㅞㅍ	뉖
ㄴㅞㅎ	뉗
ㄴㅟ	뉘
ㄴㅟㄱ	뉙
ㄴㅟㄲ	뉚
ㄴㅟㄳ	뉛
ㄴㅟㄴ	뉜
ㄴㅟㄵ	뉝
ㄴㅟㄶ	뉞
ㄴㅟㄷ	뉟
ㄴㅟㄹ	뉠
ㄴㅟㄺ	뉡
ㄴㅟㄻ	뉢
ㄴㅟㄼ	뉣
ㄴㅟㄽ	뉤
ㄴㅟㄾ	뉥
ㄴㅟㄿ	뉦
ㄴㅟㅀ	뉧
ㄴㅟㅁ	뉨
ㄴㅟㅂ	뉩
ㄴㅟㅄ	뉪
ㄴㅟㅅ	뉫
ㄴㅟㅆ	뉬
ㄴㅟㅇ	뉭
ㄴㅟㅈ	뉮
ㄴㅟㅊ	뉯
ㄴㅟㅋ	뉰
ㄴㅟㅌ	뉱
ㄴㅟㅍ	뉲
ㄴㅟㅎ	뉳
ㄴㅠ	뉴
ㄴㅠㄱ	뉵
ㄴㅠㄲ	뉶
ㄴㅠㄳ	뉷
ㄴㅠㄴ	뉸
ㄴㅠㄵ	뉹
ㄴㅠㄶ	뉺
ㄴㅠㄷ	뉻
ㄴㅠㄹ	뉼
ㄴㅠㄺ	뉽
ㄴㅠㄻ	뉾
ㄴㅠㄼ	뉿
ㄴㅠㄽ	늀
ㄴㅠㄾ	늁
ㄴㅠㄿ	늂
ㄴㅠㅀ	늃
ㄴㅠㅁ	늄
ㄴㅠㅂ	늅
ㄴㅠㅄ	늆
ㄴㅠㅅ	늇
ㄴㅠㅆ	늈
ㄴㅠㅇ	늉
ㄴㅠㅈ	늊
ㄴㅠㅊ	늋
ㄴㅠㅋ	늌
ㄴㅠㅌ	늍
ㄴㅠㅍ	늎
ㄴㅠㅎ	늏
ㄴㅡ	느
ㄴㅡㄱ	늑
ㄴㅡㄲ	늒
ㄴㅡㄳ	늓
ㄴㅡㄴ	는
ㄴㅡㄵ	늕
ㄴㅡㄶ	늖
ㄴㅡㄷ	늗
ㄴㅡㄹ	늘
ㄴㅡㄺ	늙
ㄴㅡㄻ	늚
ㄴㅡㄼ	늛
ㄴㅡㄽ	늜
ㄴㅡㄾ	늝
ㄴㅡㄿ	늞
ㄴㅡㅀ	늟
ㄴㅡㅁ	늠
ㄴㅡㅂ	늡
ㄴㅡㅄ	늢
ㄴㅡㅅ	늣
ㄴㅡㅆ	늤
ㄴㅡㅇ	능
ㄴㅡㅈ	늦
ㄴㅡㅊ	늧
ㄴㅡㅋ	늨
ㄴㅡㅌ	늩
ㄴㅡㅍ	늪
ㄴㅡㅎ	늫
ㄴㅢ	늬
ㄴㅢㄱ	늭
ㄴㅢㄲ	늮
ㄴㅢㄳ	늯
ㄴㅢㄴ	늰
ㄴㅢㄵ	늱
ㄴㅢㄶ	늲
ㄴㅢㄷ	늳
ㄴㅢㄹ	늴
ㄴㅢㄺ	늵
ㄴㅢㄻ	늶
ㄴㅢㄼ	늷
ㄴㅢㄽ	늸
ㄴㅢㄾ	늹
ㄴㅢㄿ	늺
ㄴㅢㅀ	늻
ㄴㅢㅁ	늼
ㄴㅢㅂ	늽
ㄴㅢㅄ	늾
ㄴㅢㅅ	늿
ㄴㅢㅆ	닀
ㄴㅢㅇ	닁
ㄴㅢㅈ	닂
ㄴㅢㅊ	닃
ㄴㅢㅋ	닄
ㄴㅢㅌ	닅
ㄴㅢㅍ	닆
ㄴㅢㅎ	닇
ㄴㅣ	니
ㄴㅣㄱ	닉
ㄴㅣㄲ	닊
ㄴㅣㄳ	닋
ㄴㅣㄴ	닌
ㄴㅣㄵ	닍
ㄴㅣㄶ	닎
ㄴㅣㄷ	닏
ㄴㅣㄹ	닐
ㄴㅣㄺ	닑
ㄴㅣㄻ	닒
ㄴㅣㄼ	닓
ㄴㅣㄽ	닔
ㄴㅣㄾ	닕
ㄴㅣㄿ	닖
ㄴㅣㅀ	닗
ㄴㅣㅁ	님
ㄴㅣㅂ	닙
ㄴㅣㅄ	닚
ㄴㅣㅅ	닛
ㄴㅣㅆ	닜
ㄴㅣㅇ	닝
ㄴㅣㅈ	닞
ㄴㅣㅊ	닟
ㄴㅣㅋ	닠
ㄴㅣㅌ	닡
ㄴㅣㅍ	닢
ㄴㅣㅎ	닣
ㄷㅏ	다
ㄷㅏㄱ	닥
ㄷㅏㄲ	닦
ㄷㅏㄳ	닧
ㄷㅏㄴ	단
ㄷㅏㄵ	닩
ㄷㅏㄶ	닪
ㄷㅏㄷ	닫
ㄷㅏㄹ	달
ㄷㅏㄺ	닭
ㄷㅏㄻ	닮
ㄷㅏㄼ	닯
ㄷㅏㄽ	닰
ㄷㅏㄾ	닱
ㄷㅏㄿ	닲
ㄷㅏㅀ	닳
ㄷㅏㅁ	담
ㄷㅏㅂ	답
ㄷㅏㅄ	닶
ㄷㅏㅅ	닷
ㄷㅏㅆ	닸
ㄷㅏㅇ	당
ㄷㅏㅈ	닺
ㄷㅏㅊ	닻
ㄷㅏㅋ	닼
ㄷㅏㅌ	닽
ㄷㅏㅍ	닾
ㄷㅏㅎ	닿
ㄷㅐ	대
ㄷㅐㄱ	댁
ㄷㅐㄲ	댂
ㄷㅐㄳ	댃
ㄷㅐㄴ	댄
ㄷㅐㄵ	댅
ㄷㅐㄶ	댆
ㄷㅐㄷ	댇
ㄷㅐㄹ	댈
ㄷㅐㄺ	댉
ㄷㅐㄻ	댊
ㄷㅐㄼ	댋
ㄷㅐㄽ	댌
ㄷㅐㄾ	댍
ㄷㅐㄿ	댎
ㄷㅐㅀ	댏
ㄷㅐㅁ	댐
ㄷㅐㅂ	댑
ㄷㅐㅄ	댒
ㄷㅐㅅ	댓
ㄷㅐㅆ	댔
ㄷㅐㅇ	댕
ㄷㅐㅈ	댖
ㄷㅐㅊ	댗
ㄷㅐㅋ	댘
ㄷㅐㅌ	댙
ㄷㅐㅍ	댚
ㄷㅐㅎ	댛
ㄷㅑ	댜
ㄷㅑㄱ	댝
ㄷㅑㄲ	댞
ㄷㅑㄳ	댟
ㄷㅑㄴ	댠
ㄷㅑㄵ	댡
ㄷㅑㄶ	댢
ㄷㅑㄷ	댣
ㄷㅑㄹ	댤
ㄷㅑㄺ	댥
ㄷㅑㄻ	댦
ㄷㅑㄼ	댧
ㄷㅑㄽ	댨
ㄷㅑㄾ	댩
ㄷㅑㄿ	댪
ㄷㅑㅀ	댫
ㄷㅑㅁ	댬
ㄷㅑㅂ	댭
ㄷㅑㅄ	댮
ㄷㅑㅅ	댯
ㄷㅑㅆ	댰
ㄷㅑㅇ	댱
ㄷㅑㅈ	댲
ㄷㅑㅊ	댳
ㄷㅑㅋ	댴
ㄷㅑㅌ	댵
ㄷㅑㅍ	댶
ㄷㅑㅎ	댷
ㄷㅒ	댸
ㄷㅒㄱ	댹
ㄷㅒㄲ	댺
ㄷㅒㄳ	댻
ㄷㅒㄴ	댼
ㄷㅒㄵ	댽
ㄷㅒㄶ	댾
ㄷㅒㄷ	댿
ㄷㅒㄹ	덀
ㄷㅒㄺ	덁
ㄷㅒㄻ	덂
ㄷㅒㄼ	덃
ㄷㅒㄽ	덄
ㄷㅒㄾ	덅
ㄷㅒㄿ	덆
ㄷㅒㅀ	덇
ㄷㅒㅁ	덈
ㄷㅒㅂ	덉
ㄷㅒㅄ	덊
ㄷㅒㅅ	덋
ㄷㅒㅆ	덌
ㄷㅒㅇ	덍
ㄷㅒㅈ	덎
ㄷㅒㅊ	덏
ㄷㅒㅋ	덐
ㄷㅒㅌ	덑
ㄷㅒㅍ	덒
ㄷㅒㅎ	덓
ㄷㅓ	더
ㄷㅓㄱ	덕
ㄷㅓㄲ	덖
ㄷㅓㄳ	덗
ㄷㅓㄴ	던
ㄷㅓㄵ	덙
ㄷㅓㄶ	덚
ㄷㅓㄷ	덛
ㄷㅓㄹ	덜
ㄷㅓㄺ	덝
ㄷㅓㄻ	덞
ㄷㅓㄼ	덟
ㄷㅓㄽ	덠
ㄷㅓㄾ	덡
ㄷㅓㄿ	덢
ㄷㅓㅀ	덣
ㄷㅓㅁ	덤
ㄷㅓㅂ	덥
ㄷㅓㅄ	덦
ㄷㅓㅅ	덧
ㄷㅓㅆ	덨
ㄷㅓㅇ	덩
ㄷㅓㅈ	덪
ㄷㅓㅊ	덫
ㄷㅓㅋ	덬
ㄷㅓㅌ	덭
ㄷㅓㅍ	덮
ㄷㅓㅎ	덯
ㄷㅔ	데
ㄷㅔㄱ	덱
ㄷㅔㄲ	덲
ㄷㅔㄳ	덳
ㄷㅔㄴ	덴
ㄷㅔㄵ	덵
ㄷㅔㄶ	덶
ㄷㅔㄷ	덷
ㄷㅔㄹ	델
ㄷㅔㄺ	덹
ㄷㅔㄻ	덺
ㄷㅔㄼ	덻
ㄷㅔㄽ	덼
ㄷㅔㄾ	덽
ㄷㅔㄿ	덾
ㄷㅔㅀ	덿
ㄷㅔㅁ	뎀
ㄷㅔㅂ	뎁
ㄷㅔㅄ	뎂
ㄷㅔㅅ	뎃
ㄷㅔㅆ	뎄
ㄷㅔㅇ	뎅
ㄷㅔㅈ	뎆
ㄷㅔㅊ	뎇
ㄷㅔㅋ	뎈
ㄷㅔㅌ	뎉
ㄷㅔㅍ	뎊
ㄷㅔㅎ	뎋
ㄷㅕ	뎌
ㄷㅕㄱ	뎍
ㄷㅕㄲ	뎎
ㄷㅕㄳ	뎏
ㄷㅕㄴ	뎐
ㄷㅕㄵ	뎑
ㄷㅕㄶ	뎒
ㄷㅕㄷ	뎓
ㄷㅕㄹ	뎔
ㄷㅕㄺ	뎕
ㄷㅕㄻ	뎖
ㄷㅕㄼ	뎗
ㄷㅕㄽ	뎘
ㄷㅕㄾ	뎙
ㄷㅕㄿ	뎚
ㄷㅕㅀ	뎛
ㄷㅕㅁ	뎜
ㄷㅕㅂ	뎝
ㄷㅕㅄ	뎞
ㄷㅕㅅ	뎟
ㄷㅕㅆ	뎠
ㄷㅕㅇ	뎡
ㄷㅕㅈ	뎢
ㄷㅕㅊ	뎣
ㄷㅕㅋ	뎤
ㄷㅕㅌ	뎥
ㄷㅕㅍ	뎦
ㄷㅕㅎ	뎧
ㄷㅖ	뎨
ㄷㅖㄱ	뎩
ㄷㅖㄲ	뎪
ㄷㅖㄳ	뎫
ㄷㅖㄴ	뎬
ㄷㅖㄵ	뎭
ㄷㅖㄶ	뎮
ㄷㅖㄷ	뎯
ㄷㅖㄹ	뎰
ㄷㅖㄺ	뎱
ㄷㅖㄻ	뎲
ㄷㅖㄼ	뎳
ㄷㅖㄽ	뎴
ㄷㅖㄾ	뎵
ㄷㅖㄿ	뎶
ㄷㅖㅀ	뎷
ㄷㅖㅁ	뎸
ㄷㅖㅂ	뎹
ㄷㅖㅄ	뎺
ㄷㅖㅅ	뎻
ㄷㅖㅆ	뎼
ㄷㅖㅇ	뎽
ㄷㅖㅈ	뎾
ㄷㅖㅊ	뎿
ㄷㅖㅋ	돀
ㄷㅖㅌ	돁
ㄷㅖㅍ	돂
ㄷㅖㅎ	돃
ㄷㅗ	도
ㄷㅗㄱ	독
ㄷㅗㄲ	돆
ㄷㅗㄳ	돇
ㄷㅗㄴ	돈
ㄷㅗㄵ	돉
ㄷㅗㄶ	돊
ㄷㅗㄷ	돋
ㄷㅗㄹ	돌
ㄷㅗㄺ	돍
ㄷㅗㄻ	돎
ㄷㅗㄼ	돏
ㄷㅗㄽ	돐
ㄷㅗㄾ	돑
ㄷㅗㄿ	돒
ㄷㅗㅀ	돓
ㄷㅗㅁ	돔
ㄷㅗㅂ	돕
ㄷㅗㅄ	돖
ㄷㅗㅅ	돗
ㄷㅗㅆ	돘
ㄷㅗㅇ	동
ㄷㅗㅈ	돚
ㄷㅗㅊ	돛
ㄷㅗㅋ	돜
ㄷㅗㅌ	돝
ㄷㅗㅍ	돞
ㄷㅗㅎ	돟
ㄷㅘ	돠
ㄷㅘㄱ	돡
ㄷㅘㄲ	돢
ㄷㅘㄳ	돣
ㄷㅘㄴ	돤
ㄷㅘㄵ	돥
ㄷㅘㄶ	돦
ㄷㅘㄷ	돧
ㄷㅘㄹ	돨
ㄷㅘㄺ	돩
ㄷㅘㄻ	돪
ㄷㅘㄼ	돫
ㄷㅘㄽ	돬
ㄷㅘㄾ	돭
ㄷㅘㄿ	돮
ㄷㅘㅀ	돯
ㄷㅘㅁ	돰
ㄷㅘㅂ	돱
ㄷㅘㅄ	돲
ㄷㅘㅅ	돳
ㄷㅘㅆ	돴
ㄷㅘㅇ	돵
ㄷㅘㅈ	돶
ㄷㅘㅊ	돷
ㄷㅘㅋ	돸
ㄷㅘㅌ	돹
ㄷㅘㅍ	돺
ㄷㅘㅎ	돻
ㄷㅙ	돼
ㄷㅙㄱ	돽
ㄷㅙㄲ	돾
ㄷㅙㄳ	돿
ㄷㅙㄴ	됀
ㄷㅙㄵ	됁
ㄷㅙㄶ	됂
ㄷㅙㄷ	됃
ㄷㅙㄹ	됄
ㄷㅙㄺ	됅
ㄷㅙㄻ	됆
ㄷㅙㄼ	됇
ㄷㅙㄽ	됈
ㄷㅙㄾ	됉
ㄷㅙㄿ	됊
ㄷㅙㅀ	됋
ㄷㅙㅁ	됌
ㄷㅙㅂ	됍
ㄷㅙㅄ	됎
ㄷㅙㅅ	됏
ㄷㅙㅆ	됐
ㄷㅙㅇ	됑
ㄷㅙㅈ	됒
ㄷㅙㅊ	됓
ㄷㅙㅋ	됔
ㄷㅙㅌ	됕
ㄷㅙㅍ	됖
ㄷㅙㅎ	됗
ㄷㅚ	되
ㄷㅚㄱ	됙
ㄷㅚㄲ	됚
ㄷㅚㄳ	됛
ㄷㅚㄴ	된
ㄷㅚㄵ	됝
ㄷㅚㄶ	됞
ㄷㅚㄷ	됟
ㄷㅚㄹ	될
ㄷㅚㄺ	됡
ㄷㅚㄻ	됢
ㄷㅚㄼ	됣
ㄷㅚㄽ	됤
ㄷㅚㄾ	됥
ㄷㅚㄿ	됦
ㄷㅚㅀ	됧
ㄷㅚㅁ	됨
ㄷㅚㅂ	됩
ㄷㅚㅄ	됪
ㄷㅚㅅ	됫
ㄷㅚㅆ	됬
ㄷㅚㅇ	됭
ㄷㅚㅈ	됮
ㄷㅚㅊ	됯
ㄷㅚㅋ	됰
ㄷㅚㅌ	됱
ㄷㅚㅍ	됲
ㄷㅚㅎ	됳
ㄷㅛ	됴
ㄷㅛㄱ	됵
ㄷㅛㄲ	됶
ㄷㅛㄳ	됷
ㄷㅛㄴ	됸
ㄷㅛㄵ	됹
ㄷㅛㄶ	됺
ㄷㅛㄷ	됻
ㄷㅛㄹ	됼
ㄷㅛㄺ	됽
ㄷㅛㄻ	됾
ㄷㅛㄼ	됿
ㄷㅛㄽ	둀
ㄷㅛㄾ	둁
ㄷㅛㄿ	둂
ㄷㅛㅀ	둃
ㄷㅛㅁ	둄
ㄷㅛㅂ	둅
ㄷㅛㅄ	둆
ㄷㅛㅅ	둇
ㄷㅛㅆ	둈
ㄷㅛㅇ	둉
ㄷㅛㅈ	둊
ㄷㅛㅊ	둋
ㄷㅛㅋ	둌
ㄷㅛㅌ	둍
ㄷㅛㅍ	둎
ㄷㅛㅎ	둏
ㄷㅜ	두
ㄷㅜㄱ	둑
ㄷㅜㄲ	둒
ㄷㅜㄳ	둓
ㄷㅜㄴ	둔
ㄷㅜㄵ	둕
ㄷㅜㄶ	둖
ㄷㅜㄷ	둗
ㄷㅜㄹ	둘
ㄷㅜㄺ	둙
ㄷㅜㄻ	둚
ㄷㅜㄼ	둛
ㄷㅜㄽ	둜
ㄷㅜㄾ	둝
ㄷㅜㄿ	둞
ㄷㅜㅀ	둟
ㄷㅜㅁ	둠
ㄷㅜㅂ	둡
ㄷㅜㅄ	둢
ㄷㅜㅅ	둣
ㄷㅜㅆ	둤
ㄷㅜㅇ	둥
ㄷㅜㅈ	둦
ㄷㅜㅊ	둧
ㄷㅜㅋ	둨
ㄷㅜㅌ	둩
ㄷㅜㅍ	둪
ㄷㅜㅎ	둫
ㄷㅝ	둬
ㄷㅝㄱ	둭
ㄷㅝㄲ	둮
ㄷㅝㄳ	둯
ㄷㅝㄴ	둰
ㄷㅝㄵ	둱
ㄷㅝㄶ	둲
ㄷㅝㄷ	둳
ㄷㅝㄹ	둴
ㄷㅝㄺ	둵
ㄷㅝㄻ	둶
ㄷㅝㄼ	둷
ㄷㅝㄽ	둸
ㄷㅝㄾ	둹
ㄷㅝㄿ	둺
ㄷㅝㅀ	둻
ㄷㅝㅁ	둼
ㄷㅝㅂ	둽
ㄷㅝㅄ	둾
ㄷㅝㅅ	둿
ㄷㅝㅆ	뒀
ㄷㅝㅇ	뒁
ㄷㅝㅈ	뒂
ㄷㅝㅊ	뒃
ㄷㅝㅋ	뒄
ㄷㅝㅌ	뒅
ㄷㅝㅍ	뒆
ㄷㅝㅎ	뒇
ㄷㅞ	뒈
ㄷㅞㄱ	뒉
ㄷㅞㄲ	뒊
ㄷㅞㄳ	뒋
ㄷㅞㄴ	뒌
ㄷㅞㄵ	뒍
ㄷㅞㄶ	뒎
ㄷㅞㄷ	뒏
ㄷㅞㄹ	뒐
ㄷㅞㄺ	뒑
ㄷㅞㄻ	뒒
ㄷㅞㄼ	뒓
ㄷㅞㄽ	뒔
ㄷㅞㄾ	뒕
ㄷㅞㄿ	뒖
ㄷㅞㅀ	뒗
ㄷㅞㅁ	뒘
ㄷㅞㅂ	뒙
ㄷㅞㅄ	뒚
ㄷㅞㅅ	뒛
ㄷㅞㅆ	뒜
ㄷㅞㅇ	뒝
ㄷㅞㅈ	뒞
ㄷㅞㅊ	뒟
ㄷㅞㅋ	뒠
ㄷㅞㅌ	뒡
ㄷㅞㅍ	뒢
ㄷㅞㅎ	뒣
ㄷㅟ	뒤
ㄷㅟㄱ	뒥
ㄷㅟㄲ	뒦
ㄷㅟㄳ	뒧
ㄷㅟㄴ	뒨
ㄷㅟㄵ	뒩
ㄷㅟㄶ	뒪
ㄷㅟㄷ	뒫
ㄷㅟㄹ	뒬
ㄷㅟㄺ	뒭
ㄷㅟㄻ	뒮
ㄷㅟㄼ	뒯
ㄷㅟㄽ	뒰
ㄷㅟㄾ	뒱
ㄷㅟㄿ	뒲
ㄷㅟㅀ	뒳
ㄷㅟㅁ	뒴
ㄷㅟㅂ	뒵
ㄷㅟㅄ	뒶
ㄷㅟㅅ	뒷
ㄷㅟㅆ	뒸
ㄷㅟㅇ	뒹
ㄷㅟㅈ	뒺
ㄷㅟㅊ	뒻
ㄷㅟㅋ	뒼
ㄷㅟㅌ	뒽
ㄷㅟㅍ	뒾
ㄷㅟㅎ	뒿
ㄷㅠ	듀
ㄷㅠㄱ	듁
ㄷㅠㄲ	듂
ㄷㅠㄳ	듃
ㄷㅠㄴ	듄
ㄷㅠㄵ	듅
ㄷㅠㄶ	듆
ㄷㅠㄷ	듇
ㄷㅠㄹ	듈
ㄷㅠㄺ	듉
ㄷㅠㄻ	듊
ㄷㅠㄼ	듋
ㄷㅠㄽ	듌
ㄷㅠㄾ	듍
ㄷㅠㄿ	듎
ㄷㅠㅀ	듏
ㄷㅠㅁ	듐
ㄷㅠㅂ	듑
ㄷㅠㅄ	듒
ㄷㅠㅅ	듓
ㄷㅠㅆ	듔
ㄷㅠㅇ	듕
ㄷㅠㅈ	듖
ㄷㅠㅊ	듗
ㄷㅠㅋ	듘
ㄷㅠㅌ	듙
ㄷㅠㅍ	듚
ㄷㅠㅎ	듛
ㄷㅡ	드
ㄷㅡㄱ	득
ㄷㅡㄲ	듞
ㄷㅡㄳ	듟
ㄷㅡㄴ	든
ㄷㅡㄵ	듡
ㄷㅡㄶ	듢
ㄷㅡㄷ	듣
ㄷㅡㄹ	들
ㄷㅡㄺ	듥
ㄷㅡㄻ	듦
ㄷㅡㄼ	듧
ㄷㅡㄽ	듨
ㄷㅡㄾ	듩
ㄷㅡㄿ	듪
ㄷㅡㅀ	듫
ㄷㅡㅁ	듬
ㄷㅡㅂ	듭
ㄷㅡㅄ	듮
ㄷㅡㅅ	듯
ㄷㅡㅆ	듰
ㄷㅡㅇ	등
ㄷㅡㅈ	듲
ㄷㅡㅊ	듳
ㄷㅡㅋ	듴
ㄷㅡㅌ	듵
ㄷㅡㅍ	듶
ㄷㅡㅎ	듷
ㄷㅢ	듸
ㄷㅢㄱ	듹
ㄷㅢㄲ	듺
ㄷㅢㄳ	듻
ㄷㅢㄴ	듼
ㄷㅢㄵ	듽
ㄷㅢㄶ	듾
ㄷㅢㄷ	듿
ㄷㅢㄹ	딀
ㄷㅢㄺ	딁
ㄷㅢㄻ	딂
ㄷㅢㄼ	딃
ㄷㅢㄽ	딄
ㄷㅢㄾ	딅
ㄷㅢㄿ	딆
ㄷㅢㅀ	딇
ㄷㅢㅁ	딈
ㄷㅢㅂ	딉
ㄷㅢㅄ	딊
ㄷㅢㅅ	딋
ㄷㅢㅆ	딌
ㄷㅢㅇ	딍
ㄷㅢㅈ	딎
ㄷㅢㅊ	딏
ㄷㅢㅋ	딐
ㄷㅢㅌ	딑
ㄷㅢㅍ	딒
ㄷㅢㅎ	딓
ㄷㅣ	디
ㄷㅣㄱ	딕
ㄷㅣㄲ	딖
ㄷㅣㄳ	딗
ㄷㅣㄴ	딘
ㄷㅣㄵ	딙
ㄷㅣㄶ	딚
ㄷㅣㄷ	딛
ㄷㅣㄹ	딜
ㄷㅣㄺ	딝
ㄷㅣㄻ	딞
ㄷㅣㄼ	딟
ㄷㅣㄽ	딠
ㄷㅣㄾ	딡
ㄷㅣㄿ	딢
ㄷㅣㅀ	딣
ㄷㅣㅁ	딤
ㄷㅣㅂ	딥
ㄷㅣㅄ	딦
ㄷㅣㅅ	딧
ㄷㅣㅆ	딨
ㄷㅣㅇ	딩
ㄷㅣㅈ	딪
ㄷㅣㅊ	딫
ㄷㅣㅋ	딬
ㄷㅣㅌ	딭
ㄷㅣㅍ	딮
ㄷㅣㅎ	딯
ㄸㅏ	따
ㄸㅏㄱ	딱
ㄸㅏㄲ	딲
ㄸㅏㄳ	딳
ㄸㅏㄴ	딴
ㄸㅏㄵ	딵
ㄸㅏㄶ	딶
ㄸㅏㄷ	딷
ㄸㅏㄹ	딸
ㄸㅏㄺ	딹
ㄸㅏㄻ	딺
ㄸㅏㄼ	딻
ㄸㅏㄽ	딼
ㄸㅏㄾ	딽
ㄸㅏㄿ	딾
ㄸㅏㅀ	딿
ㄸㅏㅁ	땀
ㄸㅏㅂ	땁
ㄸㅏㅄ	땂
ㄸㅏㅅ	땃
ㄸㅏㅆ	땄
ㄸㅏㅇ	땅
ㄸㅏㅈ	땆
ㄸㅏㅊ	땇
ㄸㅏㅋ	땈
ㄸㅏㅌ	땉
ㄸㅏㅍ	땊
ㄸㅏㅎ	땋
ㄸㅐ	때
ㄸㅐㄱ	땍
ㄸㅐㄲ	땎
ㄸㅐㄳ	땏
ㄸㅐㄴ	땐
ㄸㅐㄵ	땑
ㄸㅐㄶ	땒
ㄸㅐㄷ	땓
ㄸㅐㄹ	땔
ㄸㅐㄺ	땕
ㄸㅐㄻ	땖
ㄸㅐㄼ	땗
ㄸㅐㄽ	땘
ㄸㅐㄾ	땙
ㄸㅐㄿ	땚
ㄸㅐㅀ	땛
ㄸㅐㅁ	땜
ㄸㅐㅂ	땝
ㄸㅐㅄ	땞
ㄸㅐㅅ	땟
ㄸㅐㅆ	땠
ㄸㅐㅇ	땡
ㄸㅐㅈ	땢
ㄸㅐㅊ	땣
ㄸㅐㅋ	땤
ㄸㅐㅌ	땥
ㄸㅐㅍ	땦
ㄸㅐㅎ	땧
ㄸㅑ	땨
ㄸㅑㄱ	땩
ㄸㅑㄲ	땪
ㄸㅑㄳ	땫
ㄸㅑㄴ	땬
ㄸㅑㄵ	땭
ㄸㅑㄶ	땮
ㄸㅑㄷ	땯
ㄸㅑㄹ	땰
ㄸㅑㄺ	땱
ㄸㅑㄻ	땲
ㄸㅑㄼ	땳
ㄸㅑㄽ	땴
ㄸㅑㄾ	땵
ㄸㅑㄿ	땶
ㄸㅑㅀ	땷
ㄸㅑㅁ	땸
ㄸㅑㅂ	땹
ㄸㅑㅄ	땺
ㄸㅑㅅ	땻
ㄸㅑㅆ	땼
ㄸㅑㅇ	땽
ㄸㅑㅈ	땾
ㄸㅑㅊ	땿
ㄸㅑㅋ	떀
ㄸㅑㅌ	떁
ㄸㅑㅍ	떂
ㄸㅑㅎ	떃
ㄸㅒ	떄
ㄸㅒㄱ	떅
ㄸㅒㄲ	떆
ㄸㅒㄳ	떇
ㄸㅒㄴ	떈
ㄸㅒㄵ	떉
ㄸㅒㄶ	떊
ㄸㅒㄷ	떋
ㄸㅒㄹ	떌
ㄸㅒㄺ	떍
ㄸㅒㄻ	떎
ㄸㅒㄼ	떏
ㄸㅒㄽ	떐
ㄸㅒㄾ	떑
ㄸㅒㄿ	떒
ㄸㅒㅀ	떓
ㄸㅒㅁ	떔
ㄸㅒㅂ	떕
ㄸㅒㅄ	떖
ㄸㅒㅅ	떗
ㄸㅒㅆ	떘
ㄸㅒㅇ	떙
ㄸㅒㅈ	떚
ㄸㅒㅊ	떛
ㄸㅒㅋ	떜
ㄸㅒㅌ	떝
ㄸㅒㅍ	떞
ㄸㅒㅎ	떟
ㄸㅓ	떠
ㄸㅓㄱ	떡
ㄸㅓㄲ	떢
ㄸㅓㄳ	떣
ㄸㅓㄴ	떤
ㄸㅓㄵ	떥
ㄸㅓㄶ	떦
ㄸㅓㄷ	떧
ㄸㅓㄹ	떨
ㄸㅓㄺ	떩
ㄸㅓㄻ	떪
ㄸㅓㄼ	떫
ㄸㅓㄽ	떬
ㄸㅓㄾ	떭
ㄸㅓㄿ	떮
ㄸㅓㅀ	떯
ㄸㅓㅁ	떰
ㄸㅓㅂ	떱
ㄸㅓㅄ	떲
ㄸㅓㅅ	떳
ㄸㅓㅆ	떴
ㄸㅓㅇ	떵
ㄸㅓㅈ	떶
ㄸㅓㅊ	떷
ㄸㅓㅋ	떸
ㄸㅓㅌ	떹
ㄸㅓㅍ	떺
ㄸㅓㅎ	떻
ㄸㅔ	떼
ㄸㅔㄱ	떽
ㄸㅔㄲ	떾
ㄸㅔㄳ	떿
ㄸㅔㄴ	뗀
ㄸㅔㄵ	뗁
ㄸㅔㄶ	뗂
ㄸㅔㄷ	뗃
ㄸㅔㄹ	뗄
ㄸㅔㄺ	뗅
ㄸㅔㄻ	뗆
ㄸㅔㄼ	뗇
ㄸㅔㄽ	뗈
ㄸㅔㄾ	뗉
ㄸㅔㄿ	뗊
ㄸㅔㅀ	뗋
ㄸㅔㅁ	뗌
ㄸㅔㅂ	뗍
ㄸㅔㅄ	뗎
ㄸㅔㅅ	뗏
ㄸㅔㅆ	뗐
ㄸㅔㅇ	뗑
ㄸㅔㅈ	뗒
ㄸㅔㅊ	뗓
ㄸㅔㅋ	뗔
ㄸㅔㅌ	뗕
ㄸㅔㅍ	뗖
ㄸㅔㅎ	뗗
ㄸㅕ	뗘
ㄸㅕㄱ	뗙
ㄸㅕㄲ	뗚
ㄸㅕㄳ	뗛
ㄸㅕㄴ	뗜
ㄸㅕㄵ	뗝
ㄸㅕㄶ	뗞
ㄸㅕㄷ	뗟
ㄸㅕㄹ	뗠
ㄸㅕㄺ	뗡
ㄸㅕㄻ	뗢
ㄸㅕㄼ	뗣
ㄸㅕㄽ	뗤
ㄸㅕㄾ	뗥
ㄸㅕㄿ	뗦
ㄸㅕㅀ	뗧
ㄸㅕㅁ	뗨
ㄸㅕㅂ	뗩
ㄸㅕㅄ	뗪
ㄸㅕㅅ	뗫
ㄸㅕㅆ	뗬
ㄸㅕㅇ	뗭
ㄸㅕㅈ	뗮
ㄸㅕㅊ	뗯
ㄸㅕㅋ	뗰
ㄸㅕㅌ	뗱
ㄸㅕㅍ	뗲
ㄸㅕㅎ	뗳
ㄸㅖ	뗴
ㄸㅖㄱ	뗵
ㄸㅖㄲ	뗶
ㄸㅖㄳ	뗷
ㄸㅖㄴ	뗸
ㄸㅖㄵ	뗹
ㄸㅖㄶ	뗺
ㄸㅖㄷ	뗻
ㄸㅖㄹ	뗼
ㄸㅖㄺ	뗽
ㄸㅖㄻ	뗾
ㄸㅖㄼ	뗿
ㄸㅖㄽ	똀
ㄸㅖㄾ	똁
ㄸㅖㄿ	똂
ㄸㅖㅀ	똃
ㄸㅖㅁ	똄
ㄸㅖㅂ	똅
ㄸㅖㅄ	똆
ㄸㅖㅅ	똇
ㄸㅖㅆ	똈
ㄸㅖㅇ	똉
ㄸㅖㅈ	똊
ㄸㅖㅊ	똋
ㄸㅖㅋ	똌
ㄸㅖㅌ	똍
ㄸㅖㅍ	똎
ㄸㅖㅎ	똏
ㄸㅗ	또
ㄸㅗㄱ	똑
ㄸㅗㄲ	똒
ㄸㅗㄳ	똓
ㄸㅗㄴ	똔
ㄸㅗㄵ	똕
ㄸㅗㄶ	똖
ㄸㅗㄷ	똗
ㄸㅗㄹ	똘
ㄸㅗㄺ	똙
ㄸㅗㄻ	똚
ㄸㅗㄼ	똛
ㄸㅗㄽ	똜
ㄸㅗㄾ	똝
ㄸㅗㄿ	똞
ㄸㅗㅀ	똟
ㄸㅗㅁ	똠
ㄸㅗㅂ	똡
ㄸㅗㅄ	똢
ㄸㅗㅅ	똣
ㄸㅗㅆ	똤
ㄸㅗㅇ	똥
ㄸㅗㅈ	똦
ㄸㅗㅊ	똧
ㄸㅗㅋ	똨
ㄸㅗㅌ	똩
ㄸㅗㅍ	똪
ㄸㅗㅎ	똫
ㄸㅘ	똬
ㄸㅘㄱ	똭
ㄸㅘㄲ	똮
ㄸㅘㄳ	똯
ㄸㅘㄴ	똰
ㄸㅘㄵ	똱
ㄸㅘㄶ	똲
ㄸㅘㄷ	똳
ㄸㅘㄹ	똴
ㄸㅘㄺ	똵
ㄸㅘㄻ	똶
ㄸㅘㄼ	똷
ㄸㅘㄽ	똸
ㄸㅘㄾ	똹
ㄸㅘㄿ	똺
ㄸㅘㅀ	똻
ㄸㅘㅁ	똼
ㄸㅘㅂ	똽
ㄸㅘㅄ	똾
ㄸㅘㅅ	똿
ㄸㅘㅆ	뙀
ㄸㅘㅇ	뙁
ㄸㅘㅈ	뙂
ㄸㅘㅊ	뙃
ㄸㅘㅋ	뙄
ㄸㅘㅌ	뙅
ㄸㅘㅍ	뙆
ㄸㅘㅎ	뙇
ㄸㅙ	뙈
ㄸㅙㄱ	뙉
ㄸㅙㄲ	뙊
ㄸㅙㄳ	뙋
ㄸㅙㄴ	뙌
ㄸㅙㄵ	뙍
ㄸㅙㄶ	뙎
ㄸㅙㄷ	뙏
ㄸㅙㄹ	뙐
ㄸㅙㄺ	뙑
ㄸㅙㄻ	뙒
ㄸㅙㄼ	뙓
ㄸㅙㄽ	뙔
ㄸㅙㄾ	뙕
ㄸㅙㄿ	뙖
ㄸㅙㅀ	뙗
ㄸㅙㅁ	뙘
ㄸㅙㅂ	뙙
ㄸㅙㅄ	뙚
ㄸㅙㅅ	뙛
ㄸㅙㅆ	뙜
ㄸㅙㅇ	뙝
ㄸㅙㅈ	뙞
ㄸㅙㅊ	뙟
ㄸㅙㅋ	뙠
ㄸㅙㅌ	뙡
ㄸㅙㅍ	뙢
ㄸㅙㅎ	뙣
ㄸㅚ	뙤
ㄸㅚㄱ	뙥
ㄸㅚㄲ	뙦
ㄸㅚㄳ	뙧
ㄸㅚㄴ	뙨
ㄸㅚㄵ	뙩
ㄸㅚㄶ	뙪
ㄸㅚㄷ	뙫
ㄸㅚㄹ	뙬
ㄸㅚㄺ	뙭
ㄸㅚㄻ	뙮
ㄸㅚㄼ	뙯
ㄸㅚㄽ	뙰
ㄸㅚㄾ	뙱
ㄸㅚㄿ	뙲
ㄸㅚㅀ	뙳
ㄸㅚㅁ	뙴
ㄸㅚㅂ	뙵
ㄸㅚㅄ	뙶
ㄸㅚㅅ	뙷
ㄸㅚㅆ	뙸
ㄸㅚㅇ	뙹
ㄸㅚㅈ	뙺
ㄸㅚㅊ	뙻
ㄸㅚㅋ	뙼
ㄸㅚㅌ	뙽
ㄸㅚㅍ	뙾
ㄸㅚㅎ	뙿
ㄸㅛ	뚀
ㄸㅛㄱ	뚁
ㄸㅛㄲ	뚂
ㄸㅛㄳ	뚃
ㄸㅛㄴ	뚄
ㄸㅛㄵ	뚅
ㄸㅛㄶ	뚆
ㄸㅛㄷ	뚇
ㄸㅛㄹ	뚈
ㄸㅛㄺ	뚉
ㄸㅛㄻ	뚊
ㄸㅛㄼ	뚋
ㄸㅛㄽ	뚌
ㄸㅛㄾ	뚍
ㄸㅛㄿ	뚎
ㄸㅛㅀ	뚏
ㄸㅛㅁ	뚐
ㄸㅛㅂ	뚑
ㄸㅛㅄ	뚒
ㄸㅛㅅ	뚓
ㄸㅛㅆ	뚔
ㄸㅛㅇ	뚕
ㄸㅛㅈ	뚖
ㄸㅛㅊ	뚗
ㄸㅛㅋ	뚘
ㄸㅛㅌ	뚙
ㄸㅛㅍ	뚚
ㄸㅛㅎ	뚛
ㄸㅜ	뚜
ㄸㅜㄱ	뚝
ㄸㅜㄲ	뚞
ㄸㅜㄳ	뚟
ㄸㅜㄴ	뚠
ㄸㅜㄵ	뚡
ㄸㅜㄶ	뚢
ㄸㅜㄷ	뚣
ㄸㅜㄹ	뚤
ㄸㅜㄺ	뚥
ㄸㅜㄻ	뚦
ㄸㅜㄼ	뚧
ㄸㅜㄽ	뚨
ㄸㅜㄾ	뚩
ㄸㅜㄿ	뚪
ㄸㅜㅀ	뚫
ㄸㅜㅁ	뚬
ㄸㅜㅂ	뚭
ㄸㅜㅄ	뚮
ㄸㅜㅅ	뚯
ㄸㅜㅆ	뚰
ㄸㅜㅇ	뚱
ㄸㅜㅈ	뚲
ㄸㅜㅊ	뚳
ㄸㅜㅋ	뚴
ㄸㅜㅌ	뚵
ㄸㅜㅍ	뚶
ㄸㅜㅎ	뚷
ㄸㅝ	뚸
ㄸㅝㄱ	뚹
ㄸㅝㄲ	뚺
ㄸㅝㄳ	뚻
ㄸㅝㄴ	뚼
ㄸㅝㄵ	뚽
ㄸㅝㄶ	뚾
ㄸㅝㄷ	뚿
ㄸㅝㄹ	뛀
ㄸㅝㄺ	뛁
ㄸㅝㄻ	뛂
ㄸㅝㄼ	뛃
ㄸㅝㄽ	뛄
ㄸㅝㄾ	뛅
ㄸㅝㄿ	뛆
ㄸㅝㅀ	뛇
ㄸㅝㅁ	뛈
ㄸㅝㅂ	뛉
ㄸㅝㅄ	뛊
ㄸㅝㅅ	뛋
ㄸㅝㅆ	뛌
ㄸㅝㅇ	뛍
ㄸㅝㅈ	뛎
ㄸㅝㅊ	뛏
ㄸㅝㅋ	뛐
ㄸㅝㅌ	뛑
ㄸㅝㅍ	뛒
ㄸㅝㅎ	뛓
ㄸㅞ	뛔
ㄸㅞㄱ	뛕
ㄸㅞㄲ	뛖
ㄸㅞㄳ	뛗
ㄸㅞㄴ	뛘
ㄸㅞㄵ	뛙
ㄸㅞㄶ	뛚
ㄸㅞㄷ	뛛
ㄸㅞㄹ	뛜
ㄸㅞㄺ	뛝
ㄸㅞㄻ	뛞
ㄸㅞㄼ	뛟
ㄸㅞㄽ	뛠
ㄸㅞㄾ	뛡
ㄸㅞㄿ	뛢
ㄸㅞㅀ	뛣
ㄸㅞㅁ	뛤
ㄸㅞㅂ	뛥
ㄸㅞㅄ	뛦
ㄸㅞㅅ	뛧
ㄸㅞㅆ	뛨
ㄸㅞㅇ	뛩
ㄸㅞㅈ	뛪
ㄸㅞㅊ	뛫
ㄸㅞㅋ	뛬
ㄸㅞㅌ	뛭
ㄸㅞㅍ	뛮
ㄸㅞㅎ	뛯
ㄸㅟ	뛰
ㄸㅟㄱ	뛱
ㄸㅟㄲ	뛲
ㄸㅟㄳ	뛳
ㄸㅟㄴ	뛴
ㄸㅟㄵ	뛵
ㄸㅟㄶ	뛶
ㄸㅟㄷ	뛷
ㄸㅟㄹ	뛸
ㄸㅟㄺ	뛹
ㄸㅟㄻ	뛺
ㄸㅟㄼ	뛻
ㄸㅟㄽ	뛼
ㄸㅟㄾ	뛽
ㄸㅟㄿ	뛾
ㄸㅟㅀ	뛿
ㄸㅟㅁ	뜀
ㄸㅟㅂ	뜁
ㄸㅟㅄ	뜂
ㄸㅟㅅ	뜃
ㄸㅟㅆ	뜄
ㄸㅟㅇ	뜅
ㄸㅟㅈ	뜆
ㄸㅟㅊ	뜇
ㄸㅟㅋ	뜈
ㄸㅟㅌ	뜉
ㄸㅟㅍ	뜊
ㄸㅟㅎ	뜋
ㄸㅠ	뜌
ㄸㅠㄱ	뜍
ㄸㅠㄲ	뜎
ㄸㅠㄳ	뜏
ㄸㅠㄴ	뜐
ㄸㅠㄵ	뜑
ㄸㅠㄶ	뜒
ㄸㅠㄷ	뜓
ㄸㅠㄹ	뜔
ㄸㅠㄺ	뜕
ㄸㅠㄻ	뜖
ㄸㅠㄼ	뜗
ㄸㅠㄽ	뜘
ㄸㅠㄾ	뜙
ㄸㅠㄿ	뜚
ㄸㅠㅀ	뜛
ㄸㅠㅁ	뜜
ㄸㅠㅂ	뜝
ㄸㅠㅄ	뜞
ㄸㅠㅅ	뜟
ㄸㅠㅆ	뜠
ㄸㅠㅇ	뜡
ㄸㅠㅈ	뜢
ㄸㅠㅊ	뜣
ㄸㅠㅋ	뜤
ㄸㅠㅌ	뜥
ㄸㅠㅍ	뜦
ㄸㅠㅎ	뜧
ㄸㅡ	뜨
ㄸㅡㄱ	뜩
ㄸㅡㄲ	뜪
ㄸㅡㄳ	뜫
ㄸㅡㄴ	뜬
ㄸㅡㄵ	뜭
ㄸㅡㄶ	뜮
ㄸㅡㄷ	뜯
ㄸㅡㄹ	뜰
ㄸㅡㄺ	뜱
ㄸㅡㄻ	뜲
ㄸㅡㄼ	뜳
ㄸㅡㄽ	뜴
ㄸㅡㄾ	뜵
ㄸㅡㄿ	뜶
ㄸㅡㅀ	뜷
ㄸㅡㅁ	뜸
ㄸㅡㅂ	뜹
ㄸㅡㅄ	뜺
ㄸㅡㅅ	뜻
ㄸㅡㅆ	뜼
ㄸㅡㅇ	뜽
ㄸㅡㅈ	뜾
ㄸㅡㅊ	뜿
ㄸㅡㅋ	띀
ㄸㅡㅌ	띁
ㄸㅡㅍ	띂
ㄸㅡㅎ	띃
ㄸㅢ	띄
ㄸㅢㄱ	띅
ㄸㅢㄲ	띆
ㄸㅢㄳ	띇
ㄸㅢㄴ	띈
ㄸㅢㄵ	띉
ㄸㅢㄶ	띊
ㄸㅢㄷ	띋
ㄸㅢㄹ	띌
ㄸㅢㄺ	띍
ㄸㅢㄻ	띎
ㄸㅢㄼ	띏
ㄸㅢㄽ	띐
ㄸㅢㄾ	띑
ㄸㅢㄿ	띒
ㄸㅢㅀ	띓
ㄸㅢㅁ	띔
ㄸㅢㅂ	띕
ㄸㅢㅄ	띖
ㄸㅢㅅ	띗
ㄸㅢㅆ	띘
ㄸㅢㅇ	띙
ㄸㅢㅈ	띚
ㄸㅢㅊ	띛
ㄸㅢㅋ	띜
ㄸㅢㅌ	띝
ㄸㅢㅍ	띞
ㄸㅢㅎ	띟
ㄸㅣ	띠
ㄸㅣㄱ	띡
ㄸㅣㄲ	띢
ㄸㅣㄳ	띣
ㄸㅣㄴ	띤
ㄸㅣㄵ	띥
ㄸㅣㄶ	띦
ㄸㅣㄷ	띧
ㄸㅣㄹ	띨
ㄸㅣㄺ	띩
ㄸㅣㄻ	띪
ㄸㅣㄼ	띫
ㄸㅣㄽ	띬
ㄸㅣㄾ	띭
ㄸㅣㄿ	띮
ㄸㅣㅀ	띯
ㄸㅣㅁ	띰
ㄸㅣㅂ	띱
ㄸㅣㅄ	띲
ㄸㅣㅅ	띳
ㄸㅣㅆ	띴
ㄸㅣㅇ	띵
ㄸㅣㅈ	띶
ㄸㅣㅊ	띷
ㄸㅣㅋ	띸
ㄸㅣㅌ	띹
ㄸㅣㅍ	띺
ㄸㅣㅎ	띻
ㄹㅏ	라
ㄹㅏㄱ	락
ㄹㅏㄲ	띾
ㄹㅏㄳ	띿
ㄹㅏㄴ	란
ㄹㅏㄵ	랁
ㄹㅏㄶ	랂
ㄹㅏㄷ	랃
ㄹㅏㄹ	랄
ㄹㅏㄺ	랅
ㄹㅏㄻ	랆
ㄹㅏㄼ	랇
ㄹㅏㄽ	랈
ㄹㅏㄾ	랉
ㄹㅏㄿ	랊
ㄹㅏㅀ	랋
ㄹㅏㅁ	람
ㄹㅏㅂ	랍
ㄹㅏㅄ	랎
ㄹㅏㅅ	랏
ㄹㅏㅆ	랐
ㄹㅏㅇ	랑
ㄹㅏㅈ	랒
ㄹㅏㅊ	랓
ㄹㅏㅋ	랔
ㄹㅏㅌ	랕
ㄹㅏㅍ	랖
ㄹㅏㅎ	랗
ㄹㅐ	래
ㄹㅐㄱ	랙
ㄹㅐㄲ	랚
ㄹㅐㄳ	랛
ㄹㅐㄴ	랜
ㄹㅐㄵ	랝
ㄹㅐㄶ	랞
ㄹㅐㄷ	랟
ㄹㅐㄹ	랠
ㄹㅐㄺ	랡
ㄹㅐㄻ	랢
ㄹㅐㄼ	랣
ㄹㅐㄽ	랤
ㄹㅐㄾ	랥
ㄹㅐㄿ	랦
ㄹㅐㅀ	랧
ㄹㅐㅁ	램
ㄹㅐㅂ	랩
ㄹㅐㅄ	랪
ㄹㅐㅅ	랫
ㄹㅐㅆ	랬
ㄹㅐㅇ	랭
ㄹㅐㅈ	랮
ㄹㅐㅊ	랯
ㄹㅐㅋ	랰
ㄹㅐㅌ	랱
ㄹㅐㅍ	랲
ㄹㅐㅎ	랳
ㄹㅑ	랴
ㄹㅑㄱ	략
ㄹㅑㄲ	랶
ㄹㅑㄳ	랷
ㄹㅑㄴ	랸
ㄹㅑㄵ	랹
ㄹㅑㄶ	랺
ㄹㅑㄷ	랻
ㄹㅑㄹ	랼
ㄹㅑㄺ	랽
ㄹㅑㄻ	랾
ㄹㅑㄼ	랿
ㄹㅑㄽ	럀
ㄹㅑㄾ	럁
ㄹㅑㄿ	럂
ㄹㅑㅀ	럃
ㄹㅑㅁ	럄
ㄹㅑㅂ	럅
ㄹㅑㅄ	럆
ㄹㅑㅅ	럇
ㄹㅑㅆ	럈
ㄹㅑㅇ	량
ㄹㅑㅈ	럊
ㄹㅑㅊ	럋
ㄹㅑㅋ	럌
ㄹㅑㅌ	럍
ㄹㅑㅍ	럎
ㄹㅑㅎ	럏
ㄹㅒ	럐
ㄹㅒㄱ	럑
ㄹㅒㄲ	럒
ㄹㅒㄳ	럓
ㄹㅒㄴ	럔
ㄹㅒㄵ	럕
ㄹㅒㄶ	럖
ㄹㅒㄷ	럗
ㄹㅒㄹ	럘
ㄹㅒㄺ	럙
ㄹㅒㄻ	럚
ㄹㅒㄼ	럛
ㄹㅒㄽ	럜
ㄹㅒㄾ	럝
ㄹㅒㄿ	럞
ㄹㅒㅀ	럟
ㄹㅒㅁ	럠
ㄹㅒㅂ	럡
ㄹㅒㅄ	럢
ㄹㅒㅅ	럣
ㄹㅒㅆ	럤
ㄹㅒㅇ	럥
ㄹㅒㅈ	럦
ㄹㅒㅊ	럧
ㄹㅒㅋ	럨
ㄹㅒㅌ	럩
ㄹㅒㅍ	럪
ㄹㅒㅎ	럫
ㄹㅓ	러
ㄹㅓㄱ	럭
ㄹㅓㄲ	럮
ㄹㅓㄳ	럯
ㄹㅓㄴ	런
ㄹㅓㄵ	럱
ㄹㅓㄶ	럲
ㄹㅓㄷ	럳
ㄹㅓㄹ	럴
ㄹㅓㄺ	럵
ㄹㅓㄻ	럶
ㄹㅓㄼ	럷
ㄹㅓㄽ	럸
ㄹㅓㄾ	럹
ㄹㅓㄿ	럺
ㄹㅓㅀ	럻
ㄹㅓㅁ	럼
ㄹㅓㅂ	럽
ㄹㅓㅄ	럾
ㄹㅓㅅ	럿
ㄹㅓㅆ	렀
ㄹㅓㅇ	렁
ㄹㅓㅈ	렂
ㄹㅓㅊ	렃
ㄹㅓㅋ	렄
ㄹㅓㅌ	렅
ㄹㅓㅍ	렆
ㄹㅓㅎ	렇
ㄹㅔ	레
ㄹㅔㄱ	렉
ㄹㅔㄲ	렊
ㄹㅔㄳ	렋
ㄹㅔㄴ	렌
ㄹㅔㄵ	렍
ㄹㅔㄶ	렎
ㄹㅔㄷ	렏
ㄹㅔㄹ	렐
ㄹㅔㄺ	렑
ㄹㅔㄻ	렒
ㄹㅔㄼ	렓
ㄹㅔㄽ	렔
ㄹㅔㄾ	렕
ㄹㅔㄿ	렖
ㄹㅔㅀ	렗
ㄹㅔㅁ	렘
ㄹㅔㅂ	렙
ㄹㅔㅄ	렚
ㄹㅔㅅ	렛
ㄹㅔㅆ	렜
ㄹㅔㅇ	렝
ㄹㅔㅈ	렞
ㄹㅔㅊ	렟
ㄹㅔㅋ	렠
ㄹㅔㅌ	렡
ㄹㅔㅍ	렢
ㄹㅔㅎ	렣
ㄹㅕ	려
ㄹㅕㄱ	력
ㄹㅕㄲ	렦
ㄹㅕㄳ	렧
ㄹㅕㄴ	련
ㄹㅕㄵ	렩
ㄹㅕㄶ	렪
ㄹㅕㄷ	렫
ㄹㅕㄹ	렬
ㄹㅕㄺ	렭
ㄹㅕㄻ	렮
ㄹㅕㄼ	렯
ㄹㅕㄽ	렰
ㄹㅕㄾ	렱
ㄹㅕㄿ	렲
ㄹㅕㅀ	렳
ㄹㅕㅁ	렴
ㄹㅕㅂ	렵
ㄹㅕㅄ	렶
ㄹㅕㅅ	렷
ㄹㅕㅆ	렸
ㄹㅕㅇ	령
ㄹㅕㅈ	렺
ㄹㅕㅊ	렻
ㄹㅕㅋ	렼
ㄹㅕㅌ	렽
ㄹㅕㅍ	렾
ㄹㅕㅎ	렿
ㄹㅖ	례
ㄹㅖㄱ	롁
ㄹㅖㄲ	롂
ㄹㅖㄳ	롃
ㄹㅖㄴ	롄
ㄹㅖㄵ	롅
ㄹㅖㄶ	롆
ㄹㅖㄷ	롇
ㄹㅖㄹ	롈
ㄹㅖㄺ	롉
ㄹㅖㄻ	롊
ㄹㅖㄼ	롋
ㄹㅖㄽ	롌
ㄹㅖㄾ	롍
ㄹㅖㄿ	롎
ㄹㅖㅀ	롏
ㄹㅖㅁ	롐
ㄹㅖㅂ	롑
ㄹㅖㅄ	롒
ㄹㅖㅅ	롓
ㄹㅖㅆ	롔
ㄹㅖㅇ	롕
ㄹㅖㅈ	롖
ㄹㅖㅊ	롗
ㄹㅖㅋ	롘
ㄹㅖㅌ	롙
ㄹㅖㅍ	롚
ㄹㅖㅎ	롛
ㄹㅗ	로
ㄹㅗㄱ	록
ㄹㅗㄲ	롞
ㄹㅗㄳ	롟
ㄹㅗㄴ	론
ㄹㅗㄵ	롡
ㄹㅗㄶ	롢
ㄹㅗㄷ	롣
ㄹㅗㄹ	롤
ㄹㅗㄺ	롥
ㄹㅗㄻ	롦
ㄹㅗㄼ	롧
ㄹㅗㄽ	롨
ㄹㅗㄾ	롩
ㄹㅗㄿ	롪
ㄹㅗㅀ	롫
ㄹㅗㅁ	롬
ㄹㅗㅂ	롭
ㄹㅗㅄ	롮
ㄹㅗㅅ	롯
ㄹㅗㅆ	롰
ㄹㅗㅇ	롱
ㄹㅗㅈ	롲
ㄹㅗㅊ	롳
ㄹㅗㅋ	롴
ㄹㅗㅌ	롵
ㄹㅗㅍ	롶
ㄹㅗㅎ	롷
ㄹㅘ	롸
ㄹㅘㄱ	롹
ㄹㅘㄲ	롺
ㄹㅘㄳ	롻
ㄹㅘㄴ	롼
ㄹㅘㄵ	롽
ㄹㅘㄶ	롾
ㄹㅘㄷ	롿
ㄹㅘㄹ	뢀
ㄹㅘㄺ	뢁
ㄹㅘㄻ	뢂
ㄹㅘㄼ	뢃
ㄹㅘㄽ	뢄
ㄹㅘㄾ	뢅
ㄹㅘㄿ	뢆
ㄹㅘㅀ	뢇
ㄹㅘㅁ	뢈
ㄹㅘㅂ	뢉
ㄹㅘㅄ	뢊
ㄹㅘㅅ	뢋
ㄹㅘㅆ	뢌
ㄹㅘㅇ	뢍
ㄹㅘㅈ	뢎
ㄹㅘㅊ	뢏
ㄹㅘㅋ	뢐
ㄹㅘㅌ	뢑
ㄹㅘㅍ	뢒
ㄹㅘㅎ	뢓
ㄹㅙ	뢔
ㄹㅙㄱ	뢕
ㄹㅙㄲ	뢖
ㄹㅙㄳ	뢗
ㄹㅙㄴ	뢘
ㄹㅙㄵ	뢙
ㄹㅙㄶ	뢚
ㄹㅙㄷ	뢛
ㄹㅙㄹ	뢜
ㄹㅙㄺ	뢝
ㄹㅙㄻ	뢞
ㄹㅙㄼ	뢟
ㄹㅙㄽ	뢠
ㄹㅙㄾ	뢡
ㄹㅙㄿ	뢢
ㄹㅙㅀ	뢣
ㄹㅙㅁ	뢤
ㄹㅙㅂ	뢥
ㄹㅙㅄ	뢦
ㄹㅙㅅ	뢧
ㄹㅙㅆ	뢨
ㄹㅙㅇ	뢩
ㄹㅙㅈ	뢪
ㄹㅙㅊ	뢫
ㄹㅙㅋ	뢬
ㄹㅙㅌ	뢭
ㄹㅙㅍ	뢮
ㄹㅙㅎ	뢯
ㄹㅚ	뢰
ㄹㅚㄱ	뢱
ㄹㅚㄲ	뢲
ㄹㅚㄳ	뢳
ㄹㅚㄴ	뢴
ㄹㅚㄵ	뢵
ㄹㅚㄶ	뢶
ㄹㅚㄷ	뢷
ㄹㅚㄹ	뢸
ㄹㅚㄺ	뢹
ㄹㅚㄻ	뢺
ㄹㅚㄼ	뢻
ㄹㅚㄽ	뢼
ㄹㅚㄾ	뢽
ㄹㅚㄿ	뢾
ㄹㅚㅀ	뢿
ㄹㅚㅁ	룀
ㄹㅚㅂ	룁
ㄹㅚㅄ	룂
ㄹㅚㅅ	룃
ㄹㅚㅆ	룄
ㄹㅚㅇ	룅
ㄹㅚㅈ	룆
ㄹㅚㅊ	룇
ㄹㅚㅋ	룈
ㄹㅚㅌ	룉
ㄹㅚㅍ	룊
ㄹㅚㅎ	룋
ㄹㅛ	료
ㄹㅛㄱ	룍
ㄹㅛㄲ	룎
ㄹㅛㄳ	룏
ㄹㅛㄴ	룐
ㄹㅛㄵ	룑
ㄹㅛㄶ	룒
ㄹㅛㄷ	룓
ㄹㅛㄹ	룔
ㄹㅛㄺ	룕
ㄹㅛㄻ	룖
ㄹㅛㄼ	룗
ㄹㅛㄽ	룘
ㄹㅛㄾ	룙
ㄹㅛㄿ	룚
ㄹㅛㅀ	룛
ㄹㅛㅁ	룜
ㄹㅛㅂ	룝
ㄹㅛㅄ	룞
ㄹㅛㅅ	룟
ㄹㅛㅆ	룠
ㄹㅛㅇ	룡
ㄹㅛㅈ	룢
ㄹㅛㅊ	룣
ㄹㅛㅋ	룤
ㄹㅛㅌ	룥
ㄹㅛㅍ	룦
ㄹㅛㅎ	룧
ㄹㅜ	루
ㄹㅜㄱ	룩
ㄹㅜㄲ	룪
ㄹㅜㄳ	룫
ㄹㅜㄴ	룬
ㄹㅜㄵ	룭
ㄹㅜㄶ	룮
ㄹㅜㄷ	룯
ㄹㅜㄹ	룰
ㄹㅜㄺ	룱
ㄹㅜㄻ	룲
ㄹㅜㄼ	룳
ㄹㅜㄽ	룴
ㄹㅜㄾ	룵
ㄹㅜㄿ	룶
ㄹㅜㅀ	룷
ㄹㅜㅁ	룸
ㄹㅜㅂ	룹
ㄹㅜㅄ	룺
ㄹㅜㅅ	룻
ㄹㅜㅆ	룼
ㄹㅜㅇ	룽
ㄹㅜㅈ	룾
ㄹㅜㅊ	룿
ㄹㅜㅋ	뤀
ㄹㅜㅌ	뤁
ㄹㅜㅍ	뤂
ㄹㅜㅎ	뤃
ㄹㅝ	뤄
ㄹㅝㄱ	뤅
ㄹㅝㄲ	뤆
ㄹㅝㄳ	뤇
ㄹㅝㄴ	뤈
ㄹㅝㄵ	뤉
ㄹㅝㄶ	뤊
ㄹㅝㄷ	뤋
ㄹㅝㄹ	뤌
ㄹㅝㄺ	뤍
ㄹㅝㄻ	뤎
ㄹㅝㄼ	뤏
ㄹㅝㄽ	뤐
ㄹㅝㄾ	뤑
ㄹㅝㄿ	뤒
ㄹㅝㅀ	뤓
ㄹㅝㅁ	뤔
ㄹㅝㅂ	뤕
ㄹㅝㅄ	뤖
ㄹㅝㅅ	뤗
ㄹㅝㅆ	뤘
ㄹㅝㅇ	뤙
ㄹㅝㅈ	뤚
ㄹㅝㅊ	뤛
ㄹㅝㅋ	뤜
ㄹㅝㅌ	뤝
ㄹㅝㅍ	뤞
ㄹㅝㅎ	뤟
ㄹㅞ	뤠
ㄹㅞㄱ	뤡
ㄹㅞㄲ	뤢
ㄹㅞㄳ	뤣
ㄹㅞㄴ	뤤
ㄹㅞㄵ	뤥
ㄹㅞㄶ	뤦
ㄹㅞㄷ	뤧
ㄹㅞㄹ	뤨
ㄹㅞㄺ	뤩
ㄹㅞㄻ	뤪
ㄹㅞㄼ	뤫
ㄹㅞㄽ	뤬
ㄹㅞㄾ	뤭
ㄹㅞㄿ	뤮
ㄹㅞㅀ	뤯
ㄹㅞㅁ	뤰
ㄹㅞㅂ	뤱
ㄹㅞㅄ	뤲
ㄹㅞㅅ	뤳
ㄹㅞㅆ	뤴
ㄹㅞㅇ	뤵
ㄹㅞㅈ	뤶
ㄹㅞㅊ	뤷
ㄹㅞㅋ	뤸
ㄹㅞㅌ	뤹
ㄹㅞㅍ	뤺
ㄹㅞㅎ	뤻
ㄹㅟ	뤼
ㄹㅟㄱ	뤽
ㄹㅟㄲ	뤾
ㄹㅟㄳ	뤿
ㄹㅟㄴ	륀
ㄹㅟㄵ	륁
ㄹㅟㄶ	륂
ㄹㅟㄷ	륃
ㄹㅟㄹ	륄
ㄹㅟㄺ	륅
ㄹㅟㄻ	륆
ㄹㅟㄼ	륇
ㄹㅟㄽ	륈
ㄹㅟㄾ	륉
ㄹㅟㄿ	륊
ㄹㅟㅀ	륋
ㄹㅟㅁ	륌
ㄹㅟㅂ	륍
ㄹㅟㅄ	륎
ㄹㅟㅅ	륏
ㄹㅟㅆ	륐
ㄹㅟㅇ	륑
ㄹㅟㅈ	륒
ㄹㅟㅊ	륓
ㄹㅟㅋ	륔
ㄹㅟㅌ	륕
ㄹㅟㅍ	륖
ㄹㅟㅎ	륗
ㄹㅠ	류
ㄹㅠㄱ	륙
ㄹㅠㄲ	륚
ㄹㅠㄳ	륛
ㄹㅠㄴ	륜
ㄹㅠㄵ	륝
ㄹㅠㄶ	륞
ㄹㅠㄷ	륟
ㄹㅠㄹ	률
ㄹㅠㄺ	륡
ㄹㅠㄻ	륢
ㄹㅠㄼ	륣
ㄹㅠㄽ	륤
ㄹㅠㄾ	륥
ㄹㅠㄿ	륦
ㄹㅠㅀ	륧
ㄹㅠㅁ	륨
ㄹㅠㅂ	륩
ㄹㅠㅄ	륪
ㄹㅠㅅ	륫
ㄹㅠㅆ	륬
ㄹㅠㅇ	륭
ㄹㅠㅈ	륮
ㄹㅠㅊ	륯
ㄹㅠㅋ	륰
ㄹㅠㅌ	륱
ㄹㅠㅍ	륲
ㄹㅠㅎ	륳
ㄹㅡ	르
ㄹㅡㄱ	륵
ㄹㅡㄲ	륶
ㄹㅡㄳ	륷
ㄹㅡㄴ	른
ㄹㅡㄵ	륹
ㄹㅡㄶ	륺
ㄹㅡㄷ	륻
ㄹㅡㄹ	를
ㄹㅡㄺ	륽
ㄹㅡㄻ	륾
ㄹㅡㄼ	륿
ㄹㅡㄽ	릀
ㄹㅡㄾ	릁
ㄹㅡㄿ	릂
ㄹㅡㅀ	릃
ㄹㅡㅁ	름
ㄹㅡㅂ	릅
ㄹㅡㅄ	릆
ㄹㅡㅅ	릇
ㄹㅡㅆ	릈
ㄹㅡㅇ	릉
ㄹㅡㅈ	릊
ㄹㅡㅊ	릋
ㄹㅡㅋ	릌
ㄹㅡㅌ	릍
ㄹㅡㅍ	릎
ㄹㅡㅎ	릏
ㄹㅢ	릐
ㄹㅢㄱ	릑
ㄹㅢㄲ	릒
ㄹㅢㄳ	릓
ㄹㅢㄴ	릔
ㄹㅢㄵ	릕
ㄹㅢㄶ	릖
ㄹㅢㄷ	릗
ㄹㅢㄹ	릘
ㄹㅢㄺ	릙
ㄹㅢㄻ	릚
ㄹㅢㄼ	릛
ㄹㅢㄽ	릜
ㄹㅢㄾ	릝
ㄹㅢㄿ	릞
ㄹㅢㅀ	릟
ㄹㅢㅁ	릠
ㄹㅢㅂ	릡
ㄹㅢㅄ	릢
ㄹㅢㅅ	릣
ㄹㅢㅆ	릤
ㄹㅢㅇ	릥
ㄹㅢㅈ	릦
ㄹㅢㅊ	릧
ㄹㅢㅋ	릨
ㄹㅢㅌ	릩
ㄹㅢㅍ	릪
ㄹㅢㅎ	릫
ㄹㅣ	리
ㄹㅣㄱ	릭
ㄹㅣㄲ	릮
ㄹㅣㄳ	릯
ㄹㅣㄴ	린
ㄹㅣㄵ	릱
ㄹㅣㄶ	릲
ㄹㅣㄷ	릳
ㄹㅣㄹ	릴
ㄹㅣㄺ	릵
ㄹㅣㄻ	릶
ㄹㅣㄼ	릷
ㄹㅣㄽ	릸
ㄹㅣㄾ	릹
ㄹㅣㄿ	릺
ㄹㅣㅀ	릻
ㄹㅣㅁ	림
ㄹㅣㅂ	립
ㄹㅣㅄ	릾
ㄹㅣㅅ	릿
ㄹㅣㅆ	맀
ㄹㅣㅇ	링
ㄹㅣㅈ	맂
ㄹㅣㅊ	맃
ㄹㅣㅋ	맄
ㄹㅣㅌ	맅
ㄹㅣㅍ	맆
ㄹㅣㅎ	맇
ㅁㅏ	마
ㅁㅏㄱ	막
ㅁㅏㄲ	맊
ㅁㅏㄳ	맋
ㅁㅏㄴ	만
ㅁㅏㄵ	맍
ㅁㅏㄶ	많
ㅁㅏㄷ	맏
ㅁㅏㄹ	말
ㅁㅏㄺ	맑
ㅁㅏㄻ	맒
ㅁㅏㄼ	맓
ㅁㅏㄽ	맔
ㅁㅏㄾ	맕
ㅁㅏㄿ	맖
ㅁㅏㅀ	맗
ㅁㅏㅁ	맘
ㅁㅏㅂ	맙
ㅁㅏㅄ	맚
ㅁㅏㅅ	맛
ㅁㅏㅆ	맜
ㅁㅏㅇ	망
ㅁㅏㅈ	맞
ㅁㅏㅊ	맟
ㅁㅏㅋ	맠
ㅁㅏㅌ	맡
ㅁㅏㅍ	맢
ㅁㅏㅎ	맣
ㅁㅐ	매
ㅁㅐㄱ	맥
ㅁㅐㄲ	맦
ㅁㅐㄳ	맧
ㅁㅐㄴ	맨
ㅁㅐㄵ	맩
ㅁㅐㄶ	맪
ㅁㅐㄷ	맫
ㅁㅐㄹ	맬
ㅁㅐㄺ	맭
ㅁㅐㄻ	맮
ㅁㅐㄼ	맯
ㅁㅐㄽ	맰
ㅁㅐㄾ	맱
ㅁㅐㄿ	맲
ㅁㅐㅀ	맳
ㅁㅐㅁ	맴
ㅁㅐㅂ	맵
ㅁㅐㅄ	맶
ㅁㅐㅅ	맷
ㅁㅐㅆ	맸
ㅁㅐㅇ	맹
ㅁㅐㅈ	맺
ㅁㅐㅊ	맻
ㅁㅐㅋ	맼
ㅁㅐㅌ	맽
ㅁㅐㅍ	맾
ㅁㅐㅎ	맿
ㅁㅑ	먀
ㅁㅑㄱ	먁
ㅁㅑㄲ	먂
ㅁㅑㄳ	먃
ㅁㅑㄴ	먄
ㅁㅑㄵ	먅
ㅁㅑㄶ	먆
ㅁㅑㄷ	먇
ㅁㅑㄹ	먈
ㅁㅑㄺ	먉
ㅁㅑㄻ	먊
ㅁㅑㄼ	먋
ㅁㅑㄽ	먌
ㅁㅑㄾ	먍
ㅁㅑㄿ	먎
ㅁㅑㅀ	먏
ㅁㅑㅁ	먐
ㅁㅑㅂ	먑
ㅁㅑㅄ	먒
ㅁㅑㅅ	먓
ㅁㅑㅆ	먔
ㅁㅑㅇ	먕
ㅁㅑㅈ	먖
ㅁㅑㅊ	먗
ㅁㅑㅋ	먘
ㅁㅑㅌ	먙
ㅁㅑㅍ	먚
ㅁㅑㅎ	먛
ㅁㅒ	먜
ㅁㅒㄱ	먝
ㅁㅒㄲ	먞
ㅁㅒㄳ	먟
ㅁㅒㄴ	먠
ㅁㅒㄵ	먡
ㅁㅒㄶ	먢
ㅁㅒㄷ	먣
ㅁㅒㄹ	먤
ㅁㅒㄺ	먥
ㅁㅒㄻ	먦
ㅁㅒㄼ	먧
ㅁㅒㄽ	먨
ㅁㅒㄾ	먩
ㅁㅒㄿ	먪
ㅁㅒㅀ	먫
ㅁㅒㅁ	먬
ㅁㅒㅂ	먭
ㅁㅒㅄ	먮
ㅁㅒㅅ	먯
ㅁㅒㅆ	먰
ㅁㅒㅇ	먱
ㅁㅒㅈ	먲
ㅁㅒㅊ	먳
ㅁㅒㅋ	먴
ㅁㅒㅌ	먵
ㅁㅒㅍ	먶
ㅁㅒㅎ	먷
ㅁㅓ	머
ㅁㅓㄱ	먹
ㅁㅓㄲ	먺
ㅁㅓㄳ	먻
ㅁㅓㄴ	먼
ㅁㅓㄵ	먽
ㅁㅓㄶ	먾
ㅁㅓㄷ	먿
ㅁㅓㄹ	멀
ㅁㅓㄺ	멁
ㅁㅓㄻ	멂
ㅁㅓㄼ	멃
ㅁㅓㄽ	멄
ㅁㅓㄾ	멅
ㅁㅓㄿ	멆
ㅁㅓㅀ	멇
ㅁㅓㅁ	멈
ㅁㅓㅂ	멉
ㅁㅓㅄ	멊
ㅁㅓㅅ	멋
ㅁㅓㅆ	멌
ㅁㅓㅇ	멍
ㅁㅓㅈ	멎
ㅁㅓㅊ	멏
ㅁㅓㅋ	멐
ㅁㅓㅌ	멑
ㅁㅓㅍ	멒
ㅁㅓㅎ	멓
ㅁㅔ	메
ㅁㅔㄱ	멕
ㅁㅔㄲ	멖
ㅁㅔㄳ	멗
ㅁㅔㄴ	멘
ㅁㅔㄵ	멙
ㅁㅔㄶ	멚
ㅁㅔㄷ	멛
ㅁㅔㄹ	멜
ㅁㅔㄺ	멝
ㅁㅔㄻ	멞
ㅁㅔㄼ	멟
ㅁㅔㄽ	멠
ㅁㅔㄾ	멡
ㅁㅔㄿ	멢
ㅁㅔㅀ	멣
ㅁㅔㅁ	멤
ㅁㅔㅂ	멥
ㅁㅔㅄ	멦
ㅁㅔㅅ	멧
ㅁㅔㅆ	멨
ㅁㅔㅇ	멩
ㅁㅔㅈ	멪
ㅁㅔㅊ	멫
ㅁㅔㅋ	멬
ㅁㅔㅌ	멭
ㅁㅔㅍ	멮
ㅁㅔㅎ	멯
ㅁㅕ	며
ㅁㅕㄱ	멱
ㅁㅕㄲ	멲
ㅁㅕㄳ	멳
ㅁㅕㄴ	면
ㅁㅕㄵ	멵
ㅁㅕㄶ	멶
ㅁㅕㄷ	멷
ㅁㅕㄹ	멸
ㅁㅕㄺ	멹
ㅁㅕㄻ	멺
ㅁㅕㄼ	멻
ㅁㅕㄽ	멼
ㅁㅕㄾ	멽
ㅁㅕㄿ	멾
ㅁㅕㅀ	멿
ㅁㅕㅁ	몀
ㅁㅕㅂ	몁
ㅁㅕㅄ	몂
ㅁㅕㅅ	몃
ㅁㅕㅆ	몄
ㅁㅕㅇ	명
ㅁㅕㅈ	몆
ㅁㅕㅊ	몇
ㅁㅕㅋ	몈
ㅁㅕㅌ	몉
ㅁㅕㅍ	몊
ㅁㅕㅎ	몋
ㅁㅖ	몌
ㅁㅖㄱ	몍
ㅁㅖㄲ	몎
ㅁㅖㄳ	몏
ㅁㅖㄴ	몐
ㅁㅖㄵ	몑
ㅁㅖㄶ	몒
ㅁㅖㄷ	몓
ㅁㅖㄹ	몔
ㅁㅖㄺ	몕
ㅁㅖㄻ	몖
ㅁㅖㄼ	몗
ㅁㅖㄽ	몘
ㅁㅖㄾ	몙
ㅁㅖㄿ	몚
ㅁㅖㅀ	몛
ㅁㅖㅁ	몜
ㅁㅖㅂ	몝
ㅁㅖㅄ	몞
ㅁㅖㅅ	몟
ㅁㅖㅆ	몠
ㅁㅖㅇ	몡
ㅁㅖㅈ	몢
ㅁㅖㅊ	몣
ㅁㅖㅋ	몤
ㅁㅖㅌ	몥
ㅁㅖㅍ	몦
ㅁㅖㅎ	몧
ㅁㅗ	모
ㅁㅗㄱ	목
ㅁㅗㄲ	몪
ㅁㅗㄳ	몫
ㅁㅗㄴ	몬
ㅁㅗㄵ	몭
ㅁㅗㄶ	몮
ㅁㅗㄷ	몯
ㅁㅗㄹ	몰
ㅁㅗㄺ	몱
ㅁㅗㄻ	몲
ㅁㅗㄼ	몳
ㅁㅗㄽ	몴
ㅁㅗㄾ	몵
ㅁㅗㄿ	몶
ㅁㅗㅀ	몷
ㅁㅗㅁ	몸
ㅁㅗㅂ	몹
ㅁㅗㅄ	몺
ㅁㅗㅅ	못
ㅁㅗㅆ	몼
ㅁㅗㅇ	몽
ㅁㅗㅈ	몾
ㅁㅗㅊ	몿
ㅁㅗㅋ	뫀
ㅁㅗㅌ	뫁
ㅁㅗㅍ	뫂
ㅁㅗㅎ	뫃
ㅁㅘ	뫄
ㅁㅘㄱ	뫅
ㅁㅘㄲ	뫆
ㅁㅘㄳ	뫇
ㅁㅘㄴ	뫈
ㅁㅘㄵ	뫉
ㅁㅘㄶ	뫊
ㅁㅘㄷ	뫋
ㅁㅘㄹ	뫌
ㅁㅘㄺ	뫍
ㅁㅘㄻ	뫎
ㅁㅘㄼ	뫏
ㅁㅘㄽ	뫐
ㅁㅘㄾ	뫑
ㅁㅘㄿ	뫒
ㅁㅘㅀ	뫓
ㅁㅘㅁ	뫔
ㅁㅘㅂ	뫕
ㅁㅘㅄ	뫖
ㅁㅘㅅ	뫗
ㅁㅘㅆ	뫘
ㅁㅘㅇ	뫙
ㅁㅘㅈ	뫚
ㅁㅘㅊ	뫛
ㅁㅘㅋ	뫜
ㅁㅘㅌ	뫝
ㅁㅘㅍ	뫞
ㅁㅘㅎ	뫟
ㅁㅙ	뫠
ㅁㅙㄱ	뫡
ㅁㅙㄲ	뫢
ㅁㅙㄳ	뫣
ㅁㅙㄴ	뫤
ㅁㅙㄵ	뫥
ㅁㅙㄶ	뫦
ㅁㅙㄷ	뫧
ㅁㅙㄹ	뫨
ㅁㅙㄺ	뫩
ㅁㅙㄻ	뫪
ㅁㅙㄼ	뫫
ㅁㅙㄽ	뫬
ㅁㅙㄾ	뫭
ㅁㅙㄿ	뫮
ㅁㅙㅀ	뫯
ㅁㅙㅁ	뫰
ㅁㅙㅂ	뫱
ㅁㅙㅄ	뫲
ㅁㅙㅅ	뫳
ㅁㅙㅆ	뫴
ㅁㅙㅇ	뫵
ㅁㅙㅈ	뫶
ㅁㅙㅊ	뫷
ㅁㅙㅋ	뫸
ㅁㅙㅌ	뫹
ㅁㅙㅍ	뫺
ㅁㅙㅎ	뫻
ㅁㅚ	뫼
ㅁㅚㄱ	뫽
ㅁㅚㄲ	뫾
ㅁㅚㄳ	뫿
ㅁㅚㄴ	묀
ㅁㅚㄵ	묁
ㅁㅚㄶ	묂
ㅁㅚㄷ	묃
ㅁㅚㄹ	묄
ㅁㅚㄺ	묅
ㅁㅚㄻ	묆
ㅁㅚㄼ	묇
ㅁㅚㄽ	묈
ㅁㅚㄾ	묉
ㅁㅚㄿ	묊
ㅁㅚㅀ	묋
ㅁㅚㅁ	묌
ㅁㅚㅂ	묍
ㅁㅚㅄ	묎
ㅁㅚㅅ	묏
ㅁㅚㅆ	묐
ㅁㅚㅇ	묑
ㅁㅚㅈ	묒
ㅁㅚㅊ	묓
ㅁㅚㅋ	묔
ㅁㅚㅌ	묕
ㅁㅚㅍ	묖
ㅁㅚㅎ	묗
ㅁㅛ	묘
ㅁㅛㄱ	묙
ㅁㅛㄲ	묚
ㅁㅛㄳ	묛
ㅁㅛㄴ	묜
ㅁㅛㄵ	묝
ㅁㅛㄶ	묞
ㅁㅛㄷ	묟
ㅁㅛㄹ	묠
ㅁㅛㄺ	묡
ㅁㅛㄻ	묢
ㅁㅛㄼ	묣
ㅁㅛㄽ	묤
ㅁㅛㄾ	묥
ㅁㅛㄿ	묦
ㅁㅛㅀ	묧
ㅁㅛㅁ	묨
ㅁㅛㅂ	묩
ㅁㅛㅄ	묪
ㅁㅛㅅ	묫
ㅁㅛㅆ	묬
ㅁㅛㅇ	묭
ㅁㅛㅈ	묮
ㅁㅛㅊ	묯
ㅁㅛㅋ	묰
ㅁㅛㅌ	묱
ㅁㅛㅍ	묲
ㅁㅛㅎ	묳
ㅁㅜ	무
ㅁㅜㄱ	묵
ㅁㅜㄲ	묶
ㅁㅜㄳ	묷
ㅁㅜㄴ	문
ㅁㅜㄵ	묹
ㅁㅜㄶ	묺
ㅁㅜㄷ	묻
ㅁㅜㄹ	물
ㅁㅜㄺ	묽
ㅁㅜㄻ	묾
ㅁㅜㄼ	묿
ㅁㅜㄽ	뭀
ㅁㅜㄾ	뭁
ㅁㅜㄿ	뭂
ㅁㅜㅀ	뭃
ㅁㅜㅁ	뭄
ㅁㅜㅂ	뭅
ㅁㅜㅄ	뭆
ㅁㅜㅅ	뭇
ㅁㅜㅆ	뭈
ㅁㅜㅇ	뭉
ㅁㅜㅈ	뭊
ㅁㅜㅊ	뭋
ㅁㅜㅋ	뭌
ㅁㅜㅌ	뭍
ㅁㅜㅍ	뭎
ㅁㅜㅎ	뭏
ㅁㅝ	뭐
ㅁㅝㄱ	뭑
ㅁㅝㄲ	뭒
ㅁㅝㄳ	뭓
ㅁㅝㄴ	뭔
ㅁㅝㄵ	뭕
ㅁㅝㄶ	뭖
ㅁㅝㄷ	뭗
ㅁㅝㄹ	뭘
ㅁㅝㄺ	뭙
ㅁㅝㄻ	뭚
ㅁㅝㄼ	뭛
ㅁㅝㄽ	뭜
ㅁㅝㄾ	뭝
ㅁㅝㄿ	뭞
ㅁㅝㅀ	뭟
ㅁㅝㅁ	뭠
ㅁㅝㅂ	뭡
ㅁㅝㅄ	뭢
ㅁㅝㅅ	뭣
ㅁㅝㅆ	뭤
ㅁㅝㅇ	뭥
ㅁㅝㅈ	뭦
ㅁㅝㅊ	뭧
ㅁㅝㅋ	뭨
ㅁㅝㅌ	뭩
ㅁㅝㅍ	뭪
ㅁㅝㅎ	뭫
ㅁㅞ	뭬
ㅁㅞㄱ	뭭
ㅁㅞㄲ	뭮
ㅁㅞㄳ	뭯
ㅁㅞㄴ	뭰
ㅁㅞㄵ	뭱
ㅁㅞㄶ	뭲
ㅁㅞㄷ	뭳
ㅁㅞㄹ	뭴
ㅁㅞㄺ	뭵
ㅁㅞㄻ	뭶
ㅁㅞㄼ	뭷
ㅁㅞㄽ	뭸
ㅁㅞㄾ	뭹
ㅁㅞㄿ	뭺
ㅁㅞㅀ	뭻
ㅁㅞㅁ	뭼
ㅁㅞㅂ	뭽
ㅁㅞㅄ	뭾
ㅁㅞㅅ	뭿
ㅁㅞㅆ	뮀
ㅁㅞㅇ	뮁
ㅁㅞㅈ	뮂
ㅁㅞㅊ	뮃
ㅁㅞㅋ	뮄
ㅁㅞㅌ	뮅
ㅁㅞㅍ	뮆
ㅁㅞㅎ	뮇
ㅁㅟ	뮈
ㅁㅟㄱ	뮉
ㅁㅟㄲ	뮊
ㅁㅟㄳ	뮋
ㅁㅟㄴ	뮌
ㅁㅟㄵ	뮍
ㅁㅟㄶ	뮎
ㅁㅟㄷ	뮏
ㅁㅟㄹ	뮐
ㅁㅟㄺ	뮑
ㅁㅟㄻ	뮒
ㅁㅟㄼ	뮓
ㅁㅟㄽ	뮔
ㅁㅟㄾ	뮕
ㅁㅟㄿ	뮖
ㅁㅟㅀ	뮗
ㅁㅟㅁ	뮘
ㅁㅟㅂ	뮙
ㅁㅟㅄ	뮚
ㅁㅟㅅ	뮛
ㅁㅟㅆ	뮜
ㅁㅟㅇ	뮝
ㅁㅟㅈ	뮞
ㅁㅟㅊ	뮟
ㅁㅟㅋ	뮠
ㅁㅟㅌ	뮡
ㅁㅟㅍ	뮢
ㅁㅟㅎ	뮣
ㅁㅠ	뮤
ㅁㅠㄱ	뮥
ㅁㅠㄲ	뮦
ㅁㅠㄳ	뮧
ㅁㅠㄴ	뮨
ㅁㅠㄵ	뮩
ㅁㅠㄶ	뮪
ㅁㅠㄷ	뮫
ㅁㅠㄹ	뮬
ㅁㅠㄺ	뮭
ㅁㅠㄻ	뮮
ㅁㅠㄼ	뮯
ㅁㅠㄽ	뮰
ㅁㅠㄾ	뮱
ㅁㅠㄿ	뮲
ㅁㅠㅀ	뮳
ㅁㅠㅁ	뮴
ㅁㅠㅂ	뮵
ㅁㅠㅄ	뮶
ㅁㅠㅅ	뮷
ㅁㅠㅆ	뮸
ㅁㅠㅇ	뮹
ㅁㅠㅈ	뮺
ㅁㅠㅊ	뮻
ㅁㅠㅋ	뮼
ㅁㅠㅌ	뮽
ㅁㅠㅍ	뮾
ㅁㅠㅎ	뮿
ㅁㅡ	므
ㅁㅡㄱ	믁
ㅁㅡㄲ	믂
ㅁㅡㄳ	믃
ㅁㅡㄴ	믄
ㅁㅡㄵ	믅
ㅁㅡㄶ	믆
ㅁㅡㄷ	믇
ㅁㅡㄹ	믈
ㅁㅡㄺ	믉
ㅁㅡㄻ	믊
ㅁㅡㄼ	믋
ㅁㅡㄽ	믌
ㅁㅡㄾ	믍
ㅁㅡㄿ	믎
ㅁㅡㅀ	믏
ㅁㅡㅁ	믐
ㅁㅡㅂ	믑
ㅁㅡㅄ	믒
ㅁㅡㅅ	믓
ㅁㅡㅆ	믔
ㅁㅡㅇ	믕
ㅁㅡㅈ	믖
ㅁㅡㅊ	믗
ㅁㅡㅋ	믘
ㅁㅡㅌ	믙
ㅁㅡㅍ	믚
ㅁㅡㅎ	믛
ㅁㅢ	믜
ㅁㅢㄱ	믝
ㅁㅢㄲ	믞
ㅁㅢㄳ	믟
ㅁㅢㄴ	믠
ㅁㅢㄵ	믡
ㅁㅢㄶ	믢
ㅁㅢㄷ	믣
ㅁㅢㄹ	믤
ㅁㅢㄺ	믥
ㅁㅢㄻ	믦
ㅁㅢㄼ	믧
ㅁㅢㄽ	믨
ㅁㅢㄾ	믩
ㅁㅢㄿ	믪
ㅁㅢㅀ	믫
ㅁㅢㅁ	믬
ㅁㅢㅂ	믭
ㅁㅢㅄ	믮
ㅁㅢㅅ	믯
ㅁㅢㅆ	믰
ㅁㅢㅇ	믱
ㅁㅢㅈ	믲
ㅁㅢㅊ	믳
ㅁㅢㅋ	믴
ㅁㅢㅌ	믵
ㅁㅢㅍ	믶
ㅁㅢㅎ	믷
ㅁㅣ	미
ㅁㅣㄱ	믹
ㅁㅣㄲ	믺
ㅁㅣㄳ	믻
ㅁㅣㄴ	민
ㅁㅣㄵ	믽
ㅁㅣㄶ	믾
ㅁㅣㄷ	믿
ㅁㅣㄹ	밀
ㅁㅣㄺ	밁
ㅁㅣㄻ	밂
ㅁㅣㄼ	밃
ㅁㅣㄽ	밄
ㅁㅣㄾ	밅
ㅁㅣㄿ	밆
ㅁㅣㅀ	밇
ㅁㅣㅁ	밈
ㅁㅣㅂ	밉
ㅁㅣㅄ	밊
ㅁㅣㅅ	밋
ㅁㅣㅆ	밌
ㅁㅣㅇ	밍
ㅁㅣㅈ	밎
ㅁㅣㅊ	및
ㅁㅣㅋ	밐
ㅁㅣㅌ	밑
ㅁㅣㅍ	밒
ㅁㅣㅎ	밓
ㅂㅏ	바
ㅂㅏㄱ	박
ㅂㅏㄲ	밖
ㅂㅏㄳ	밗
ㅂㅏㄴ	반
ㅂㅏㄵ	밙
ㅂㅏㄶ	밚
ㅂㅏㄷ	받
ㅂㅏㄹ	발
ㅂㅏㄺ	밝
ㅂㅏㄻ	밞
ㅂㅏㄼ	밟
ㅂㅏㄽ	밠
ㅂㅏㄾ	밡
ㅂㅏㄿ	밢
ㅂㅏㅀ	밣
ㅂㅏㅁ	밤
ㅂㅏㅂ	밥
ㅂㅏㅄ	밦
ㅂㅏㅅ	밧
ㅂㅏㅆ	밨
ㅂㅏㅇ	방
ㅂㅏㅈ	밪
ㅂㅏㅊ	밫
ㅂㅏㅋ	밬
ㅂㅏㅌ	밭
ㅂㅏㅍ	밮
ㅂㅏㅎ	밯
ㅂㅐ	배
ㅂㅐㄱ	백
ㅂㅐㄲ	밲
ㅂㅐㄳ	밳
ㅂㅐㄴ	밴
ㅂㅐㄵ	밵
ㅂㅐㄶ	밶
ㅂㅐㄷ	밷
ㅂㅐㄹ	밸
ㅂㅐㄺ	밹
ㅂㅐㄻ	밺
ㅂㅐㄼ	밻
ㅂㅐㄽ	밼
ㅂㅐㄾ	밽
ㅂㅐㄿ	밾
ㅂㅐㅀ	밿
ㅂㅐㅁ	뱀
ㅂㅐㅂ	뱁
ㅂㅐㅄ	뱂
ㅂㅐㅅ	뱃
ㅂㅐㅆ	뱄
ㅂㅐㅇ	뱅
ㅂㅐㅈ	뱆
ㅂㅐㅊ	뱇
ㅂㅐㅋ	뱈
ㅂㅐㅌ	뱉
ㅂㅐㅍ	뱊
ㅂㅐㅎ	뱋
ㅂㅑ	뱌
ㅂㅑㄱ	뱍
ㅂㅑㄲ	뱎
ㅂㅑㄳ	뱏
ㅂㅑㄴ	뱐
ㅂㅑㄵ	뱑
ㅂㅑㄶ	뱒
ㅂㅑㄷ	뱓
ㅂㅑㄹ	뱔
ㅂㅑㄺ	뱕
ㅂㅑㄻ	뱖
ㅂㅑㄼ	뱗
ㅂㅑㄽ	뱘
ㅂㅑㄾ	뱙
ㅂㅑㄿ	뱚
ㅂㅑㅀ	뱛
ㅂㅑㅁ	뱜
ㅂㅑㅂ	뱝
ㅂㅑㅄ	뱞
ㅂㅑㅅ	뱟
ㅂㅑㅆ	뱠
ㅂㅑㅇ	뱡
ㅂㅑㅈ	뱢
ㅂㅑㅊ	뱣
ㅂㅑㅋ	뱤
ㅂㅑㅌ	뱥
ㅂㅑㅍ	뱦
ㅂㅑㅎ	뱧
ㅂㅒ	뱨
ㅂㅒㄱ	뱩
ㅂㅒㄲ	뱪
ㅂㅒㄳ	뱫
ㅂㅒㄴ	뱬
ㅂㅒㄵ	뱭
ㅂㅒㄶ	뱮
ㅂㅒㄷ	뱯
ㅂㅒㄹ	뱰
ㅂㅒㄺ	뱱
ㅂㅒㄻ	뱲
ㅂㅒㄼ	뱳
ㅂㅒㄽ	뱴
ㅂㅒㄾ	뱵
ㅂㅒㄿ	뱶
ㅂㅒㅀ	뱷
ㅂㅒㅁ	뱸
ㅂㅒㅂ	뱹
ㅂㅒㅄ	뱺
ㅂㅒㅅ	뱻
ㅂㅒㅆ	뱼
ㅂㅒㅇ	뱽
ㅂㅒㅈ	뱾
ㅂㅒㅊ	뱿
ㅂㅒㅋ	벀
ㅂㅒㅌ	벁
ㅂㅒㅍ	벂
ㅂㅒㅎ	벃
ㅂㅓ	버
ㅂㅓㄱ	벅
ㅂㅓㄲ	벆
ㅂㅓㄳ	벇
ㅂㅓㄴ	번
ㅂㅓㄵ	벉
ㅂㅓㄶ	벊
ㅂㅓㄷ	벋
ㅂㅓㄹ	벌
ㅂㅓㄺ	벍
ㅂㅓㄻ	벎
ㅂㅓㄼ	벏
ㅂㅓㄽ	벐
ㅂㅓㄾ	벑
ㅂㅓㄿ	벒
ㅂㅓㅀ	벓
ㅂㅓㅁ	범
ㅂㅓㅂ	법
ㅂㅓㅄ	벖
ㅂㅓㅅ	벗
ㅂㅓㅆ	벘
ㅂㅓㅇ	벙
ㅂㅓㅈ	벚
ㅂㅓㅊ	벛
ㅂㅓㅋ	벜
ㅂㅓㅌ	벝
ㅂㅓㅍ	벞
ㅂㅓㅎ	벟
ㅂㅔ	베
ㅂㅔㄱ	벡
ㅂㅔㄲ	벢
ㅂㅔㄳ	벣
ㅂㅔㄴ	벤
ㅂㅔㄵ	벥
ㅂㅔㄶ	벦
ㅂㅔㄷ	벧
ㅂㅔㄹ	벨
ㅂㅔㄺ	벩
ㅂㅔㄻ	벪
ㅂㅔㄼ	벫
ㅂㅔㄽ	벬
ㅂㅔㄾ	벭
ㅂㅔㄿ	벮
ㅂㅔㅀ	벯
ㅂㅔㅁ	벰
ㅂㅔㅂ	벱
ㅂㅔㅄ	벲
ㅂㅔㅅ	벳
ㅂㅔㅆ	벴
ㅂㅔㅇ	벵
ㅂㅔㅈ	벶
ㅂㅔㅊ	벷
ㅂㅔㅋ	벸
ㅂㅔㅌ	벹
ㅂㅔㅍ	벺
ㅂㅔㅎ	벻
ㅂㅕ	벼
ㅂㅕㄱ	벽
ㅂㅕㄲ	벾
ㅂㅕㄳ	벿
ㅂㅕㄴ	변
ㅂㅕㄵ	볁
ㅂㅕㄶ	볂
ㅂㅕㄷ	볃
ㅂㅕㄹ	별
ㅂㅕㄺ	볅
ㅂㅕㄻ	볆
ㅂㅕㄼ	볇
ㅂㅕㄽ	볈
ㅂㅕㄾ	볉
ㅂㅕㄿ	볊
ㅂㅕㅀ	볋
ㅂㅕㅁ	볌
ㅂㅕㅂ	볍
ㅂㅕㅄ	볎
ㅂㅕㅅ	볏
ㅂㅕㅆ	볐
ㅂㅕㅇ	병
ㅂㅕㅈ	볒
ㅂㅕㅊ	볓
ㅂㅕㅋ	볔
ㅂㅕㅌ	볕
ㅂㅕㅍ	볖
ㅂㅕㅎ	볗
ㅂㅖ	볘
ㅂㅖㄱ	볙
ㅂㅖㄲ	볚
ㅂㅖㄳ	볛
ㅂㅖㄴ	볜
ㅂㅖㄵ	볝
ㅂㅖㄶ	볞
ㅂㅖㄷ	볟
ㅂㅖㄹ	볠
ㅂㅖㄺ	볡
ㅂㅖㄻ	볢
ㅂㅖㄼ	볣
ㅂㅖㄽ	볤
ㅂㅖㄾ	볥
ㅂㅖㄿ	볦
ㅂㅖㅀ	볧
ㅂㅖㅁ	볨
ㅂㅖㅂ	볩
ㅂㅖㅄ	볪
ㅂㅖㅅ	볫
ㅂㅖㅆ	볬
ㅂㅖㅇ	볭
ㅂㅖㅈ	볮
ㅂㅖㅊ	볯
ㅂㅖㅋ	볰
ㅂㅖㅌ	볱
ㅂㅖㅍ	볲
ㅂㅖㅎ	볳
ㅂㅗ	보
ㅂㅗㄱ	복
ㅂㅗㄲ	볶
ㅂㅗㄳ	볷
ㅂㅗㄴ	본
ㅂㅗㄵ	볹
ㅂㅗㄶ	볺
ㅂㅗㄷ	볻
ㅂㅗㄹ	볼
ㅂㅗㄺ	볽
ㅂㅗㄻ	볾
ㅂㅗㄼ	볿
ㅂㅗㄽ	봀
ㅂㅗㄾ	봁
ㅂㅗㄿ	봂
ㅂㅗㅀ	봃
ㅂㅗㅁ	봄
ㅂㅗㅂ	봅
ㅂㅗㅄ	봆
ㅂㅗㅅ	봇
ㅂㅗㅆ	봈
ㅂㅗㅇ	봉
ㅂㅗㅈ	봊
ㅂㅗㅊ	봋
ㅂㅗㅋ	봌
ㅂㅗㅌ	봍
ㅂㅗㅍ	봎
ㅂㅗㅎ	봏
ㅂㅘ	봐
ㅂㅘㄱ	봑
ㅂㅘㄲ	봒
ㅂㅘㄳ	봓
ㅂㅘㄴ	봔
ㅂㅘㄵ	봕
ㅂㅘㄶ	봖
ㅂㅘㄷ	봗
ㅂㅘㄹ	봘
ㅂㅘㄺ	봙
ㅂㅘㄻ	봚
ㅂㅘㄼ	봛
ㅂㅘㄽ	봜
ㅂㅘㄾ	봝
ㅂㅘㄿ	봞
ㅂㅘㅀ	봟
ㅂㅘㅁ	봠
ㅂㅘㅂ	봡
ㅂㅘㅄ	봢
ㅂㅘㅅ	봣
ㅂㅘㅆ	봤
ㅂㅘㅇ	봥
ㅂㅘㅈ	봦
ㅂㅘㅊ	봧
ㅂㅘㅋ	봨
ㅂㅘㅌ	봩
ㅂㅘㅍ	봪
ㅂㅘㅎ	봫
ㅂㅙ	봬
ㅂㅙㄱ	봭
ㅂㅙㄲ	봮
ㅂㅙㄳ	봯
ㅂㅙㄴ	봰
ㅂㅙㄵ	봱
ㅂㅙㄶ	봲
ㅂㅙㄷ	봳
ㅂㅙㄹ	봴
ㅂㅙㄺ	봵
ㅂㅙㄻ	봶
ㅂㅙㄼ	봷
ㅂㅙㄽ	봸
ㅂㅙㄾ	봹
ㅂㅙㄿ	봺
ㅂㅙㅀ	봻
ㅂㅙㅁ	봼
ㅂㅙㅂ	봽
ㅂㅙㅄ	봾
ㅂㅙㅅ	봿
ㅂㅙㅆ	뵀
ㅂㅙㅇ	뵁
ㅂㅙㅈ	뵂
ㅂㅙㅊ	뵃
ㅂㅙㅋ	뵄
ㅂㅙㅌ	뵅
ㅂㅙㅍ	뵆
ㅂㅙㅎ	뵇
ㅂㅚ	뵈
ㅂㅚㄱ	뵉
ㅂㅚㄲ	뵊
ㅂㅚㄳ	뵋
ㅂㅚㄴ	뵌
ㅂㅚㄵ	뵍
ㅂㅚㄶ	뵎
ㅂㅚㄷ	뵏
ㅂㅚㄹ	뵐
ㅂㅚㄺ	뵑
ㅂㅚㄻ	뵒
ㅂㅚㄼ	뵓
ㅂㅚㄽ	뵔
ㅂㅚㄾ	뵕
ㅂㅚㄿ	뵖
ㅂㅚㅀ	뵗
ㅂㅚㅁ	뵘
ㅂㅚㅂ	뵙
ㅂㅚㅄ	뵚
ㅂㅚㅅ	뵛
ㅂㅚㅆ	뵜
ㅂㅚㅇ	뵝
ㅂㅚㅈ	뵞
ㅂㅚㅊ	뵟
ㅂㅚㅋ	뵠
ㅂㅚㅌ	뵡
ㅂㅚㅍ	뵢
ㅂㅚㅎ	뵣
ㅂㅛ	뵤
ㅂㅛㄱ	뵥
ㅂㅛㄲ	뵦
ㅂㅛㄳ	뵧
ㅂㅛㄴ	뵨
ㅂㅛㄵ	뵩
ㅂㅛㄶ	뵪
ㅂㅛㄷ	뵫
ㅂㅛㄹ	뵬
ㅂㅛㄺ	뵭
ㅂㅛㄻ	뵮
ㅂㅛㄼ	뵯
ㅂㅛㄽ	뵰
ㅂㅛㄾ	뵱
ㅂㅛㄿ	뵲
ㅂㅛㅀ	뵳
ㅂㅛㅁ	뵴
ㅂㅛㅂ	뵵
ㅂㅛㅄ	뵶
ㅂㅛㅅ	뵷
ㅂㅛㅆ	뵸
ㅂㅛㅇ	뵹
ㅂㅛㅈ	뵺
ㅂㅛㅊ	뵻
ㅂㅛㅋ	뵼
ㅂㅛㅌ	뵽
ㅂㅛㅍ	뵾
ㅂㅛㅎ	뵿
ㅂㅜ	부
ㅂㅜㄱ	북
ㅂㅜㄲ	붂
ㅂㅜㄳ	붃
ㅂㅜㄴ	분
ㅂㅜㄵ	붅
ㅂㅜㄶ	붆
ㅂㅜㄷ	붇
ㅂㅜㄹ	불
ㅂㅜㄺ	붉
ㅂㅜㄻ	붊
ㅂㅜㄼ	붋
ㅂㅜㄽ	붌
ㅂㅜㄾ	붍
ㅂㅜㄿ	붎
ㅂㅜㅀ	붏
ㅂㅜㅁ	붐
ㅂㅜㅂ	붑
ㅂㅜㅄ	붒
ㅂㅜㅅ	붓
ㅂㅜㅆ	붔
ㅂㅜㅇ	붕
ㅂㅜㅈ	붖
ㅂㅜㅊ	붗
ㅂㅜㅋ	붘
ㅂㅜㅌ	붙
ㅂㅜㅍ	붚
ㅂㅜㅎ	붛
ㅂㅝ	붜
ㅂㅝㄱ	붝
ㅂㅝㄲ	붞
ㅂㅝㄳ	붟
ㅂㅝㄴ	붠
ㅂㅝㄵ	붡
ㅂㅝㄶ	붢
ㅂㅝㄷ	붣
ㅂㅝㄹ	붤
ㅂㅝㄺ	붥
ㅂㅝㄻ	붦
ㅂㅝㄼ	붧
ㅂㅝㄽ	붨
ㅂㅝㄾ	붩
ㅂㅝㄿ	붪
ㅂㅝㅀ	붫
ㅂㅝㅁ	붬
ㅂㅝㅂ	붭
ㅂㅝㅄ	붮
ㅂㅝㅅ	붯
ㅂㅝㅆ	붰
ㅂㅝㅇ	붱
ㅂㅝㅈ	붲
ㅂㅝㅊ	붳
ㅂㅝㅋ	붴
ㅂㅝㅌ	붵
ㅂㅝㅍ	붶
ㅂㅝㅎ	붷
ㅂㅞ	붸
ㅂㅞㄱ	붹
ㅂㅞㄲ	붺
ㅂㅞㄳ	붻
ㅂㅞㄴ	붼
ㅂㅞㄵ	붽
ㅂㅞㄶ	붾
ㅂㅞㄷ	붿
ㅂㅞㄹ	뷀
ㅂㅞㄺ	뷁
ㅂㅞㄻ	뷂
ㅂㅞㄼ	뷃
ㅂㅞㄽ	뷄
ㅂㅞㄾ	뷅
ㅂㅞㄿ	뷆
ㅂㅞㅀ	뷇
ㅂㅞㅁ	뷈
ㅂㅞㅂ	뷉
ㅂㅞㅄ	뷊
ㅂㅞㅅ	뷋
ㅂㅞㅆ	뷌
ㅂㅞㅇ	뷍
ㅂㅞㅈ	뷎
ㅂㅞㅊ	뷏
ㅂㅞㅋ	뷐
ㅂㅞㅌ	뷑
ㅂㅞㅍ	뷒
ㅂㅞㅎ	뷓
ㅂㅟ	뷔
ㅂㅟㄱ	뷕
ㅂㅟㄲ	뷖
ㅂㅟㄳ	뷗
ㅂㅟㄴ	뷘
ㅂㅟㄵ	뷙
ㅂㅟㄶ	뷚
ㅂㅟㄷ	뷛
ㅂㅟㄹ	뷜
ㅂㅟㄺ	뷝
ㅂㅟㄻ	뷞
ㅂㅟㄼ	뷟
ㅂㅟㄽ	뷠
ㅂㅟㄾ	뷡
ㅂㅟㄿ	뷢
ㅂㅟㅀ	뷣
ㅂㅟㅁ	뷤
ㅂㅟㅂ	뷥
ㅂㅟㅄ	뷦
ㅂㅟㅅ	뷧
ㅂㅟㅆ	뷨
ㅂㅟㅇ	뷩
ㅂㅟㅈ	뷪
ㅂㅟㅊ	뷫
ㅂㅟㅋ	뷬
ㅂㅟㅌ	뷭
ㅂㅟㅍ	뷮
ㅂㅟㅎ	뷯
ㅂㅠ	뷰
ㅂㅠㄱ	뷱
ㅂㅠㄲ	뷲
ㅂㅠㄳ	뷳
ㅂㅠㄴ	뷴
ㅂㅠㄵ	뷵
ㅂㅠㄶ	뷶
ㅂㅠㄷ	뷷
ㅂㅠㄹ	뷸
ㅂㅠㄺ	뷹
ㅂㅠㄻ	뷺
ㅂㅠㄼ	뷻
ㅂㅠㄽ	뷼
ㅂㅠㄾ	뷽
ㅂㅠㄿ	뷾
ㅂㅠㅀ	뷿
ㅂㅠㅁ	븀
ㅂㅠㅂ	븁
ㅂㅠㅄ	븂
ㅂㅠㅅ	븃
ㅂㅠㅆ	븄
ㅂㅠㅇ	븅
ㅂㅠㅈ	븆
ㅂㅠㅊ	븇
ㅂㅠㅋ	븈
ㅂㅠㅌ	븉
ㅂㅠㅍ	븊
ㅂㅠㅎ	븋
ㅂㅡ	브
ㅂㅡㄱ	븍
ㅂㅡㄲ	븎
ㅂㅡㄳ	븏
ㅂㅡㄴ	븐
ㅂㅡㄵ	븑
ㅂㅡㄶ	븒
ㅂㅡㄷ	븓
ㅂㅡㄹ	블
ㅂㅡㄺ	븕
ㅂㅡㄻ	븖
ㅂㅡㄼ	븗
ㅂㅡㄽ	븘
ㅂㅡㄾ	븙
ㅂㅡㄿ	븚
ㅂㅡㅀ	븛
ㅂㅡㅁ	븜
ㅂㅡㅂ	븝
ㅂㅡㅄ	븞
ㅂㅡㅅ	븟
ㅂㅡㅆ	븠
ㅂㅡㅇ	븡
ㅂㅡㅈ	븢
ㅂㅡㅊ	븣
ㅂㅡㅋ	븤
ㅂㅡㅌ	븥
ㅂㅡㅍ	븦
ㅂㅡㅎ	븧
ㅂㅢ	븨
ㅂㅢㄱ	븩
ㅂㅢㄲ	븪
ㅂㅢㄳ	븫
ㅂㅢㄴ	븬
ㅂㅢㄵ	븭
ㅂㅢㄶ	븮
ㅂㅢㄷ	븯
ㅂㅢㄹ	븰
ㅂㅢㄺ	븱
ㅂㅢㄻ	븲
ㅂㅢㄼ	븳
ㅂㅢㄽ	븴
ㅂㅢㄾ	븵
ㅂㅢㄿ	븶
ㅂㅢㅀ	븷
ㅂㅢㅁ	븸
ㅂㅢㅂ	븹
ㅂㅢㅄ	븺
ㅂㅢㅅ	븻
ㅂㅢㅆ	븼
ㅂㅢㅇ	븽
ㅂㅢㅈ	븾
ㅂㅢㅊ	븿
ㅂㅢㅋ	빀
ㅂㅢㅌ	빁
ㅂㅢㅍ	빂
ㅂㅢㅎ	빃
ㅂㅣ	비
ㅂㅣㄱ	빅
ㅂㅣㄲ	빆
ㅂㅣㄳ	빇
ㅂㅣㄴ	빈
ㅂㅣㄵ	빉
ㅂㅣㄶ	빊
ㅂㅣㄷ	빋
ㅂㅣㄹ	빌
ㅂㅣㄺ	빍
ㅂㅣㄻ	빎
ㅂㅣㄼ	빏
ㅂㅣㄽ	빐
ㅂㅣㄾ	빑
ㅂㅣㄿ	빒
ㅂㅣㅀ	빓
ㅂㅣㅁ	빔
ㅂㅣㅂ	빕
ㅂㅣㅄ	빖
ㅂㅣㅅ	빗
ㅂㅣㅆ	빘
ㅂㅣㅇ	빙
ㅂㅣㅈ	빚
ㅂㅣㅊ	빛
ㅂㅣㅋ	빜
ㅂㅣㅌ	빝
ㅂㅣㅍ	빞
ㅂㅣㅎ	빟
ㅃㅏ	빠
ㅃㅏㄱ	빡
ㅃㅏㄲ	빢
ㅃㅏㄳ	빣
ㅃㅏㄴ	빤
ㅃㅏㄵ	빥
ㅃㅏㄶ	빦
ㅃㅏㄷ	빧
ㅃㅏㄹ	빨
ㅃㅏㄺ	빩
ㅃㅏㄻ	빪
ㅃㅏㄼ	빫
ㅃㅏㄽ	빬
ㅃㅏㄾ	빭
ㅃㅏㄿ	빮
ㅃㅏㅀ	빯
ㅃㅏㅁ	빰
ㅃㅏㅂ	빱
ㅃㅏㅄ	빲
ㅃㅏㅅ	빳
ㅃㅏㅆ	빴
ㅃㅏㅇ	빵
ㅃㅏㅈ	빶
ㅃㅏㅊ	빷
ㅃㅏㅋ	빸
ㅃㅏㅌ	빹
ㅃㅏㅍ	빺
ㅃㅏㅎ	빻
ㅃㅐ	빼
ㅃㅐㄱ	빽
ㅃㅐㄲ	빾
ㅃㅐㄳ	빿
ㅃㅐㄴ	뺀
ㅃㅐㄵ	뺁
ㅃㅐㄶ	뺂
ㅃㅐㄷ	뺃
ㅃㅐㄹ	뺄
ㅃㅐㄺ	뺅
ㅃㅐㄻ	뺆
ㅃㅐㄼ	뺇
ㅃㅐㄽ	뺈
ㅃㅐㄾ	뺉
ㅃㅐㄿ	뺊
ㅃㅐㅀ	뺋
ㅃㅐㅁ	뺌
ㅃㅐㅂ	뺍
ㅃㅐㅄ	뺎
ㅃㅐㅅ	뺏
ㅃㅐㅆ	뺐
ㅃㅐㅇ	뺑
ㅃㅐㅈ	뺒
ㅃㅐㅊ	뺓
ㅃㅐㅋ	뺔
ㅃㅐㅌ	뺕
ㅃㅐㅍ	뺖
ㅃㅐㅎ	뺗
ㅃㅑ	뺘
ㅃㅑㄱ	뺙
ㅃㅑㄲ	뺚
ㅃㅑㄳ	뺛
ㅃㅑㄴ	뺜
ㅃㅑㄵ	뺝
ㅃㅑㄶ	뺞
ㅃㅑㄷ	뺟
ㅃㅑㄹ	뺠
ㅃㅑㄺ	뺡
ㅃㅑㄻ	뺢
ㅃㅑㄼ	뺣
ㅃㅑㄽ	뺤
ㅃㅑㄾ	뺥
ㅃㅑㄿ	뺦
ㅃㅑㅀ	뺧
ㅃㅑㅁ	뺨
ㅃㅑㅂ	뺩
ㅃㅑㅄ	뺪
ㅃㅑㅅ	뺫
ㅃㅑㅆ	뺬
ㅃㅑㅇ	뺭
ㅃㅑㅈ	뺮
ㅃㅑㅊ	뺯
ㅃㅑㅋ	뺰
ㅃㅑㅌ	뺱
ㅃㅑㅍ	뺲
ㅃㅑㅎ	뺳
ㅃㅒ	뺴
ㅃㅒㄱ	뺵
ㅃㅒㄲ	뺶
ㅃㅒㄳ	뺷
ㅃㅒㄴ	뺸
ㅃㅒㄵ	뺹
ㅃㅒㄶ	뺺
ㅃㅒㄷ	뺻
ㅃㅒㄹ	뺼
ㅃㅒㄺ	뺽
ㅃㅒㄻ	뺾
ㅃㅒㄼ	뺿
ㅃㅒㄽ	뻀
ㅃㅒㄾ	뻁
ㅃㅒㄿ	뻂
ㅃㅒㅀ	뻃
ㅃㅒㅁ	뻄
ㅃㅒㅂ	뻅
ㅃㅒㅄ	뻆
ㅃㅒㅅ	뻇
ㅃㅒㅆ	뻈
ㅃㅒㅇ	뻉
ㅃㅒㅈ	뻊
ㅃㅒㅊ	뻋
ㅃㅒㅋ	뻌
ㅃㅒㅌ	뻍
ㅃㅒㅍ	뻎
ㅃㅒㅎ	뻏
ㅃㅓ	뻐
ㅃㅓㄱ	뻑
ㅃㅓㄲ	뻒
ㅃㅓㄳ	뻓
ㅃㅓㄴ	뻔
ㅃㅓㄵ	뻕
ㅃㅓㄶ	뻖
ㅃㅓㄷ	뻗
ㅃㅓㄹ	뻘
ㅃㅓㄺ	뻙
ㅃㅓㄻ	뻚
ㅃㅓㄼ	뻛
ㅃㅓㄽ	뻜
ㅃㅓㄾ	뻝
ㅃㅓㄿ	뻞
ㅃㅓㅀ	뻟
ㅃㅓㅁ	뻠
ㅃㅓㅂ	뻡
ㅃㅓㅄ	뻢
ㅃㅓㅅ	뻣
ㅃㅓㅆ	뻤
ㅃㅓㅇ	뻥
ㅃㅓㅈ	뻦
ㅃㅓㅊ	뻧
ㅃㅓㅋ	뻨
ㅃㅓㅌ	뻩
ㅃㅓㅍ	뻪
ㅃㅓㅎ	뻫
ㅃㅔ	뻬
ㅃㅔㄱ	뻭
ㅃㅔㄲ	뻮
ㅃㅔㄳ	뻯
ㅃㅔㄴ	뻰
ㅃㅔㄵ	뻱
ㅃㅔㄶ	뻲
ㅃㅔㄷ	뻳
ㅃㅔㄹ	뻴
ㅃㅔㄺ	뻵
ㅃㅔㄻ	뻶
ㅃㅔㄼ	뻷
ㅃㅔㄽ	뻸
ㅃㅔㄾ	뻹
ㅃㅔㄿ	뻺
ㅃㅔㅀ	뻻
ㅃㅔㅁ	뻼
ㅃㅔㅂ	뻽
ㅃㅔㅄ	뻾
ㅃㅔㅅ	뻿
ㅃㅔㅆ	뼀
ㅃㅔㅇ	뼁
ㅃㅔㅈ	뼂
ㅃㅔㅊ	뼃
ㅃㅔㅋ	뼄
ㅃㅔㅌ	뼅
ㅃㅔㅍ	뼆
ㅃㅔㅎ	뼇
ㅃㅕ	뼈
ㅃㅕㄱ	뼉
ㅃㅕㄲ	뼊
ㅃㅕㄳ	뼋
ㅃㅕㄴ	뼌
ㅃㅕㄵ	뼍
ㅃㅕㄶ	뼎
ㅃㅕㄷ	뼏
ㅃㅕㄹ	뼐
ㅃㅕㄺ	뼑
ㅃㅕㄻ	뼒
ㅃㅕㄼ	뼓
ㅃㅕㄽ	뼔
ㅃㅕㄾ	뼕
ㅃㅕㄿ	뼖
ㅃㅕㅀ	뼗
ㅃㅕㅁ	뼘
ㅃㅕㅂ	뼙
ㅃㅕㅄ	뼚
ㅃㅕㅅ	뼛
ㅃㅕㅆ	뼜
ㅃㅕㅇ	뼝
ㅃㅕㅈ	뼞
ㅃㅕㅊ	뼟
ㅃㅕㅋ	뼠
ㅃㅕㅌ	뼡
ㅃㅕㅍ	뼢
ㅃㅕㅎ	뼣
ㅃㅖ	뼤
ㅃㅖㄱ	뼥
ㅃㅖㄲ	뼦
ㅃㅖㄳ	뼧
ㅃㅖㄴ	뼨
ㅃㅖㄵ	뼩
ㅃㅖㄶ	뼪
ㅃㅖㄷ	뼫
ㅃㅖㄹ	뼬
ㅃㅖㄺ	뼭
ㅃㅖㄻ	뼮
ㅃㅖㄼ	뼯
ㅃㅖㄽ	뼰
ㅃㅖㄾ	뼱
ㅃㅖㄿ	뼲
ㅃㅖㅀ	뼳
ㅃㅖㅁ	뼴
ㅃㅖㅂ	뼵
ㅃㅖㅄ	뼶
ㅃㅖㅅ	뼷
ㅃㅖㅆ	뼸
ㅃㅖㅇ	뼹
ㅃㅖㅈ	뼺
ㅃㅖㅊ	뼻
ㅃㅖㅋ	뼼
ㅃㅖㅌ	뼽
ㅃㅖㅍ	뼾
ㅃㅖㅎ	뼿
ㅃㅗ	뽀
ㅃㅗㄱ	뽁
ㅃㅗㄲ	뽂
ㅃㅗㄳ	뽃
ㅃㅗㄴ	뽄
ㅃㅗㄵ	뽅
ㅃㅗㄶ	뽆
ㅃㅗㄷ	뽇
ㅃㅗㄹ	뽈
ㅃㅗㄺ	뽉
ㅃㅗㄻ	뽊
ㅃㅗㄼ	뽋
ㅃㅗㄽ	뽌
ㅃㅗㄾ	뽍
ㅃㅗㄿ	뽎
ㅃㅗㅀ	뽏
ㅃㅗㅁ	뽐
ㅃㅗㅂ	뽑
ㅃㅗㅄ	뽒
ㅃㅗㅅ	뽓
ㅃㅗㅆ	뽔
ㅃㅗㅇ	뽕
ㅃㅗㅈ	뽖
ㅃㅗㅊ	뽗
ㅃㅗㅋ	뽘
ㅃㅗㅌ	뽙
ㅃㅗㅍ	뽚
ㅃㅗㅎ	뽛
ㅃㅘ	뽜
ㅃㅘㄱ	뽝
ㅃㅘㄲ	뽞
ㅃㅘㄳ	뽟
ㅃㅘㄴ	뽠
ㅃㅘㄵ	뽡
ㅃㅘㄶ	뽢
ㅃㅘㄷ	뽣
ㅃㅘㄹ	뽤
ㅃㅘㄺ	뽥
ㅃㅘㄻ	뽦
ㅃㅘㄼ	뽧
ㅃㅘㄽ	뽨
ㅃㅘㄾ	뽩
ㅃㅘㄿ	뽪
ㅃㅘㅀ	뽫
ㅃㅘㅁ	뽬
ㅃㅘㅂ	뽭
ㅃㅘㅄ	뽮
ㅃㅘㅅ	뽯
ㅃㅘㅆ	뽰
ㅃㅘㅇ	뽱
ㅃㅘㅈ	뽲
ㅃㅘㅊ	뽳
ㅃㅘㅋ	뽴
ㅃㅘㅌ	뽵
ㅃㅘㅍ	뽶
ㅃㅘㅎ	뽷
ㅃㅙ	뽸
ㅃㅙㄱ	뽹
ㅃㅙㄲ	뽺
ㅃㅙㄳ	뽻
ㅃㅙㄴ	뽼
ㅃㅙㄵ	뽽
ㅃㅙㄶ	뽾
ㅃㅙㄷ	뽿
ㅃㅙㄹ	뾀
ㅃㅙㄺ	뾁
ㅃㅙㄻ	뾂
ㅃㅙㄼ	뾃
ㅃㅙㄽ	뾄
ㅃㅙㄾ	뾅
ㅃㅙㄿ	뾆
ㅃㅙㅀ	뾇
ㅃㅙㅁ	뾈
ㅃㅙㅂ	뾉
ㅃㅙㅄ	뾊
ㅃㅙㅅ	뾋
ㅃㅙㅆ	뾌
ㅃㅙㅇ	뾍
ㅃㅙㅈ	뾎
ㅃㅙㅊ	뾏
ㅃㅙㅋ	뾐
ㅃㅙㅌ	뾑
ㅃㅙㅍ	뾒
ㅃㅙㅎ	뾓
ㅃㅚ	뾔
ㅃㅚㄱ	뾕
ㅃㅚㄲ	뾖
ㅃㅚㄳ	뾗
ㅃㅚㄴ	뾘
ㅃㅚㄵ	뾙
ㅃㅚㄶ	뾚
ㅃㅚㄷ	뾛
ㅃㅚㄹ	뾜
ㅃㅚㄺ	뾝
ㅃㅚㄻ	뾞
ㅃㅚㄼ	뾟
ㅃㅚㄽ	뾠
ㅃㅚㄾ	뾡
ㅃㅚㄿ	뾢
ㅃㅚㅀ	뾣
ㅃㅚㅁ	뾤
ㅃㅚㅂ	뾥
ㅃㅚㅄ	뾦
ㅃㅚㅅ	뾧
ㅃㅚㅆ	뾨
ㅃㅚㅇ	뾩
ㅃㅚㅈ	뾪
ㅃㅚㅊ	뾫
ㅃㅚㅋ	뾬
ㅃㅚㅌ	뾭
ㅃㅚㅍ	뾮
ㅃㅚㅎ	뾯
ㅃㅛ	뾰
ㅃㅛㄱ	뾱
ㅃㅛㄲ	뾲
ㅃㅛㄳ	뾳
ㅃㅛㄴ	뾴
ㅃㅛㄵ	뾵
ㅃㅛㄶ	뾶
ㅃㅛㄷ	뾷
ㅃㅛㄹ	뾸
ㅃㅛㄺ	뾹
ㅃㅛㄻ	뾺
ㅃㅛㄼ	뾻
ㅃㅛㄽ	뾼
ㅃㅛㄾ	뾽
ㅃㅛㄿ	뾾
ㅃㅛㅀ	뾿
ㅃㅛㅁ	뿀
ㅃㅛㅂ	뿁
ㅃㅛㅄ	뿂
ㅃㅛㅅ	뿃
ㅃㅛㅆ	뿄
ㅃㅛㅇ	뿅
ㅃㅛㅈ	뿆
ㅃㅛㅊ	뿇
ㅃㅛㅋ	뿈
ㅃㅛㅌ	뿉
ㅃㅛㅍ	뿊
ㅃㅛㅎ	뿋
ㅃㅜ	뿌
ㅃㅜㄱ	뿍
ㅃㅜㄲ	뿎
ㅃㅜㄳ	뿏
ㅃㅜㄴ	뿐
ㅃㅜㄵ	뿑
ㅃㅜㄶ	뿒
ㅃㅜㄷ	뿓
ㅃㅜㄹ	뿔
ㅃㅜㄺ	뿕
ㅃㅜㄻ	뿖
ㅃㅜㄼ	뿗
ㅃㅜㄽ	뿘
ㅃㅜㄾ	뿙
ㅃㅜㄿ	뿚
ㅃㅜㅀ	뿛
ㅃㅜㅁ	뿜
ㅃㅜㅂ	뿝
ㅃㅜㅄ	뿞
ㅃㅜㅅ	뿟
ㅃㅜㅆ	뿠
ㅃㅜㅇ	뿡
ㅃㅜㅈ	뿢
ㅃㅜㅊ	뿣
ㅃㅜㅋ	뿤
ㅃㅜㅌ	뿥
ㅃㅜㅍ	뿦
ㅃㅜㅎ	뿧
ㅃㅝ	뿨
ㅃㅝㄱ	뿩
ㅃㅝㄲ	뿪
ㅃㅝㄳ	뿫
ㅃㅝㄴ	뿬
ㅃㅝㄵ	뿭
ㅃㅝㄶ	뿮
ㅃㅝㄷ	뿯
ㅃㅝㄹ	뿰
ㅃㅝㄺ	뿱
ㅃㅝㄻ	뿲
ㅃㅝㄼ	뿳
ㅃㅝㄽ	뿴
ㅃㅝㄾ	뿵
ㅃㅝㄿ	뿶
ㅃㅝㅀ	뿷
ㅃㅝㅁ	뿸
ㅃㅝㅂ	뿹
ㅃㅝㅄ	뿺
ㅃㅝㅅ	뿻
ㅃㅝㅆ	뿼
ㅃㅝㅇ	뿽
ㅃㅝㅈ	뿾
ㅃㅝㅊ	뿿
ㅃㅝㅋ	쀀
ㅃㅝㅌ	쀁
ㅃㅝㅍ	쀂
ㅃㅝㅎ	쀃
ㅃㅞ	쀄
ㅃㅞㄱ	쀅
ㅃㅞㄲ	쀆
ㅃㅞㄳ	쀇
ㅃㅞㄴ	쀈
ㅃㅞㄵ	쀉
ㅃㅞㄶ	쀊
ㅃㅞㄷ	쀋
ㅃㅞㄹ	쀌
ㅃㅞㄺ	쀍
ㅃㅞㄻ	쀎
ㅃㅞㄼ	쀏
ㅃㅞㄽ	쀐
ㅃㅞㄾ	쀑
ㅃㅞㄿ	쀒
ㅃㅞㅀ	쀓
ㅃㅞㅁ	쀔
ㅃㅞㅂ	쀕
ㅃㅞㅄ	쀖
ㅃㅞㅅ	쀗
ㅃㅞㅆ	쀘
ㅃㅞㅇ	쀙
ㅃㅞㅈ	쀚
ㅃㅞㅊ	쀛
ㅃㅞㅋ	쀜
ㅃㅞㅌ	쀝
ㅃㅞㅍ	쀞
ㅃㅞㅎ	쀟
ㅃㅟ	쀠
ㅃㅟㄱ	쀡
ㅃㅟㄲ	쀢
ㅃㅟㄳ	쀣
ㅃㅟㄴ	쀤
ㅃㅟㄵ	쀥
ㅃㅟㄶ	쀦
ㅃㅟㄷ	쀧
ㅃㅟㄹ	쀨
ㅃㅟㄺ	쀩
ㅃㅟㄻ	쀪
ㅃㅟㄼ	쀫
ㅃㅟㄽ	쀬
ㅃㅟㄾ	쀭
ㅃㅟㄿ	쀮
ㅃㅟㅀ	쀯
ㅃㅟㅁ	쀰
ㅃㅟㅂ	쀱
ㅃㅟㅄ	쀲
ㅃㅟㅅ	쀳
ㅃㅟㅆ	쀴
ㅃㅟㅇ	쀵
ㅃㅟㅈ	쀶
ㅃㅟㅊ	쀷
ㅃㅟㅋ	쀸
ㅃㅟㅌ	쀹
ㅃㅟㅍ	쀺
ㅃㅟㅎ	쀻
ㅃㅠ	쀼
ㅃㅠㄱ	쀽
ㅃㅠㄲ	쀾
ㅃㅠㄳ	쀿
ㅃㅠㄴ	쁀
ㅃㅠㄵ	쁁
ㅃㅠㄶ	쁂
ㅃㅠㄷ	쁃
ㅃㅠㄹ	쁄
ㅃㅠㄺ	쁅
ㅃㅠㄻ	쁆
ㅃㅠㄼ	쁇
ㅃㅠㄽ	쁈
ㅃㅠㄾ	쁉
ㅃㅠㄿ	쁊
ㅃㅠㅀ	쁋
ㅃㅠㅁ	쁌
ㅃㅠㅂ	쁍
ㅃㅠㅄ	쁎
ㅃㅠㅅ	쁏
ㅃㅠㅆ	쁐
ㅃㅠㅇ	쁑
ㅃㅠㅈ	쁒
ㅃㅠㅊ	쁓
ㅃㅠㅋ	쁔
ㅃㅠㅌ	쁕
ㅃㅠㅍ	쁖
ㅃㅠㅎ	쁗
ㅃㅡ	쁘
ㅃㅡㄱ	쁙
ㅃㅡㄲ	쁚
ㅃㅡㄳ	쁛
ㅃㅡㄴ	쁜
ㅃㅡㄵ	쁝
ㅃㅡㄶ	쁞
ㅃㅡㄷ	쁟
ㅃㅡㄹ	쁠
ㅃㅡㄺ	쁡
ㅃㅡㄻ	쁢
ㅃㅡㄼ	쁣
ㅃㅡㄽ	쁤
ㅃㅡㄾ	쁥
ㅃㅡㄿ	쁦
ㅃㅡㅀ	쁧
ㅃㅡㅁ	쁨
ㅃㅡㅂ	쁩
ㅃㅡㅄ	쁪
ㅃㅡㅅ	쁫
ㅃㅡㅆ	쁬
ㅃㅡㅇ	쁭
ㅃㅡㅈ	쁮
ㅃㅡㅊ	쁯
ㅃㅡㅋ	쁰
ㅃㅡㅌ	쁱
ㅃㅡㅍ	쁲
ㅃㅡㅎ	쁳
ㅃㅢ	쁴
ㅃㅢㄱ	쁵
ㅃㅢㄲ	쁶
ㅃㅢㄳ	쁷
ㅃㅢㄴ	쁸
ㅃㅢㄵ	쁹
ㅃㅢㄶ	쁺
ㅃㅢㄷ	쁻
ㅃㅢㄹ	쁼
ㅃㅢㄺ	쁽
ㅃㅢㄻ	쁾
ㅃㅢㄼ	쁿
ㅃㅢㄽ	삀
ㅃㅢㄾ	삁
ㅃㅢㄿ	삂
ㅃㅢㅀ	삃
ㅃㅢㅁ	삄
ㅃㅢㅂ	삅
ㅃㅢㅄ	삆
ㅃㅢㅅ	삇
ㅃㅢㅆ	삈
ㅃㅢㅇ	삉
ㅃㅢㅈ	삊
ㅃㅢㅊ	삋
ㅃㅢㅋ	삌
ㅃㅢㅌ	삍
ㅃㅢㅍ	삎
ㅃㅢㅎ	삏
ㅃㅣ	삐
ㅃㅣㄱ	삑
ㅃㅣㄲ	삒
ㅃㅣㄳ	삓
ㅃㅣㄴ	삔
ㅃㅣㄵ	삕
ㅃㅣㄶ	삖
ㅃㅣㄷ	삗
ㅃㅣㄹ	삘
ㅃㅣㄺ	삙
ㅃㅣㄻ	삚
ㅃㅣㄼ	삛
ㅃㅣㄽ	삜
ㅃㅣㄾ	삝
ㅃㅣㄿ	삞
ㅃㅣㅀ	삟
ㅃㅣㅁ	삠
ㅃㅣㅂ	삡
ㅃㅣㅄ	삢
ㅃㅣㅅ	삣
ㅃㅣㅆ	삤
ㅃㅣㅇ	삥
ㅃㅣㅈ	삦
ㅃㅣㅊ	삧
ㅃㅣㅋ	삨
ㅃㅣㅌ	삩
ㅃㅣㅍ	삪
ㅃㅣㅎ	삫
ㅅㅏ	사
ㅅㅏㄱ	삭
ㅅㅏㄲ	삮
ㅅㅏㄳ	삯
ㅅㅏㄴ	산
ㅅㅏㄵ	삱
ㅅㅏㄶ	삲
ㅅㅏㄷ	삳
ㅅㅏㄹ	살
ㅅㅏㄺ	삵
ㅅㅏㄻ	삶
ㅅㅏㄼ	삷
ㅅㅏㄽ	삸
ㅅㅏㄾ	삹
ㅅㅏㄿ	삺
ㅅㅏㅀ	삻
ㅅㅏㅁ	삼
ㅅㅏㅂ	삽
ㅅㅏㅄ	삾
ㅅㅏㅅ	삿
ㅅㅏㅆ	샀
ㅅㅏㅇ	상
ㅅㅏㅈ	샂
ㅅㅏㅊ	샃
ㅅㅏㅋ	샄
ㅅㅏㅌ	샅
ㅅㅏㅍ	샆
ㅅㅏㅎ	샇
ㅅㅐ	새
ㅅㅐㄱ	색
ㅅㅐㄲ	샊
ㅅㅐㄳ	샋
ㅅㅐㄴ	샌
ㅅㅐㄵ	샍
ㅅㅐㄶ	샎
ㅅㅐㄷ	샏
ㅅㅐㄹ	샐
ㅅㅐㄺ	샑
ㅅㅐㄻ	샒
ㅅㅐㄼ	샓
ㅅㅐㄽ	샔
ㅅㅐㄾ	샕
ㅅㅐㄿ	샖
ㅅㅐㅀ	샗
ㅅㅐㅁ	샘
ㅅㅐㅂ	샙
ㅅㅐㅄ	샚
ㅅㅐㅅ	샛
ㅅㅐㅆ	샜
ㅅㅐㅇ	생
ㅅㅐㅈ	샞
ㅅㅐㅊ	샟
ㅅㅐㅋ	샠
ㅅㅐㅌ	샡
ㅅㅐㅍ	샢
ㅅㅐㅎ	샣
ㅅㅑ	샤
ㅅㅑㄱ	샥
ㅅㅑㄲ	샦
ㅅㅑㄳ	샧
ㅅㅑㄴ	샨
ㅅㅑㄵ	샩
ㅅㅑㄶ	샪
ㅅㅑㄷ	샫
ㅅㅑㄹ	샬
ㅅㅑㄺ	샭
ㅅㅑㄻ	샮
ㅅㅑㄼ	샯
ㅅㅑㄽ	샰
ㅅㅑㄾ	샱
ㅅㅑㄿ	샲
ㅅㅑㅀ	샳
ㅅㅑㅁ	샴
ㅅㅑㅂ	샵
ㅅㅑㅄ	샶
ㅅㅑㅅ	샷
ㅅㅑㅆ	샸
ㅅㅑㅇ	샹
ㅅㅑㅈ	샺
ㅅㅑㅊ	샻
ㅅㅑㅋ	샼
ㅅㅑㅌ	샽
ㅅㅑㅍ	샾
ㅅㅑㅎ	샿
ㅅㅒ	섀
ㅅㅒㄱ	섁
ㅅㅒㄲ	섂
ㅅㅒㄳ	섃
ㅅㅒㄴ	섄
ㅅㅒㄵ	섅
ㅅㅒㄶ	섆
ㅅㅒㄷ	섇
ㅅㅒㄹ	섈
ㅅㅒㄺ	섉
ㅅㅒㄻ	섊
ㅅㅒㄼ	섋
ㅅㅒㄽ	섌
ㅅㅒㄾ	섍
ㅅㅒㄿ	섎
ㅅㅒㅀ	섏
ㅅㅒㅁ	섐
ㅅㅒㅂ	섑
ㅅㅒㅄ	섒
ㅅㅒㅅ	섓
ㅅㅒㅆ	섔
ㅅㅒㅇ	섕
ㅅㅒㅈ	섖
ㅅㅒㅊ	섗
ㅅㅒㅋ	섘
ㅅㅒㅌ	섙
ㅅㅒㅍ	섚
ㅅㅒㅎ	섛
ㅅㅓ	서
ㅅㅓㄱ	석
ㅅㅓㄲ	섞
ㅅㅓㄳ	섟
ㅅㅓㄴ	선
ㅅㅓㄵ	섡
ㅅㅓㄶ	섢
ㅅㅓㄷ	섣
ㅅㅓㄹ	설
ㅅㅓㄺ	섥
ㅅㅓㄻ	섦
ㅅㅓㄼ	섧
ㅅㅓㄽ	섨
ㅅㅓㄾ	섩
ㅅㅓㄿ	섪
ㅅㅓㅀ	섫
ㅅㅓㅁ	섬
ㅅㅓㅂ	섭
ㅅㅓㅄ	섮
ㅅㅓㅅ	섯
ㅅㅓㅆ	섰
ㅅㅓㅇ	성
ㅅㅓㅈ	섲
ㅅㅓㅊ	섳
ㅅㅓㅋ	섴
ㅅㅓㅌ	섵
ㅅㅓㅍ	섶
ㅅㅓㅎ	섷
ㅅㅔ	세
ㅅㅔㄱ	섹
ㅅㅔㄲ	섺
ㅅㅔㄳ	섻
ㅅㅔㄴ	센
ㅅㅔㄵ	섽
ㅅㅔㄶ	섾
ㅅㅔㄷ	섿
ㅅㅔㄹ	셀
ㅅㅔㄺ	셁
ㅅㅔㄻ	셂
ㅅㅔㄼ	셃
ㅅㅔㄽ	셄
ㅅㅔㄾ	셅
ㅅㅔㄿ	셆
ㅅㅔㅀ	셇
ㅅㅔㅁ	셈
ㅅㅔㅂ	셉
ㅅㅔㅄ	셊
ㅅㅔㅅ	셋
ㅅㅔㅆ	셌
ㅅㅔㅇ	셍
ㅅㅔㅈ	셎
ㅅㅔㅊ	셏
ㅅㅔㅋ	셐
ㅅㅔㅌ	셑
ㅅㅔㅍ	셒
ㅅㅔㅎ	셓
ㅅㅕ	셔
ㅅㅕㄱ	셕
ㅅㅕㄲ	셖
ㅅㅕㄳ	셗
ㅅㅕㄴ	션
ㅅㅕㄵ	셙
ㅅㅕㄶ	셚
ㅅㅕㄷ	셛
ㅅㅕㄹ	셜
ㅅㅕㄺ	셝
ㅅㅕㄻ	셞
ㅅㅕㄼ	셟
ㅅㅕㄽ	셠
ㅅㅕㄾ	셡
ㅅㅕㄿ	셢
ㅅㅕㅀ	셣
ㅅㅕㅁ	셤
ㅅㅕㅂ	셥
ㅅㅕㅄ	셦
ㅅㅕㅅ	셧
ㅅㅕㅆ	셨
ㅅㅕㅇ	셩
ㅅㅕㅈ	셪
ㅅㅕㅊ	셫
ㅅㅕㅋ	셬
ㅅㅕㅌ	셭
ㅅㅕㅍ	셮
ㅅㅕㅎ	셯
ㅅㅖ	셰
ㅅㅖㄱ	셱
ㅅㅖㄲ	셲
ㅅㅖㄳ	셳
ㅅㅖㄴ	셴
ㅅㅖㄵ	셵
ㅅㅖㄶ	셶
ㅅㅖㄷ	셷
ㅅㅖㄹ	셸
ㅅㅖㄺ	셹
ㅅㅖㄻ	셺
ㅅㅖㄼ	셻
ㅅㅖㄽ	셼
ㅅㅖㄾ	셽
ㅅㅖㄿ	셾
ㅅㅖㅀ	셿
ㅅㅖㅁ	솀
ㅅㅖㅂ	솁
ㅅㅖㅄ	솂
ㅅㅖㅅ	솃
ㅅㅖㅆ	솄
ㅅㅖㅇ	솅
ㅅㅖㅈ	솆
ㅅㅖㅊ	솇
ㅅㅖㅋ	솈
ㅅㅖㅌ	솉
ㅅㅖㅍ	솊
ㅅㅖㅎ	솋
ㅅㅗ	소
ㅅㅗㄱ	속
ㅅㅗㄲ	솎
ㅅㅗㄳ	솏
ㅅㅗㄴ	손
ㅅㅗㄵ	솑
ㅅㅗㄶ	솒
ㅅㅗㄷ	솓
ㅅㅗㄹ	솔
ㅅㅗㄺ	솕
ㅅㅗㄻ	솖
ㅅㅗㄼ	솗
ㅅㅗㄽ	솘
ㅅㅗㄾ	솙
ㅅㅗㄿ	솚
ㅅㅗㅀ	솛
ㅅㅗㅁ	솜
ㅅㅗㅂ	솝
ㅅㅗㅄ	솞
ㅅㅗㅅ	솟
ㅅㅗㅆ	솠
ㅅㅗㅇ	송
ㅅㅗㅈ	솢
ㅅㅗㅊ	솣
ㅅㅗㅋ	솤
ㅅㅗㅌ	솥
ㅅㅗㅍ	솦
ㅅㅗㅎ	솧
ㅅㅘ	솨
ㅅㅘㄱ	솩
ㅅㅘㄲ	솪
ㅅㅘㄳ	솫
ㅅㅘㄴ	솬
ㅅㅘㄵ	솭
ㅅㅘㄶ	솮
ㅅㅘㄷ	솯
ㅅㅘㄹ	솰
ㅅㅘㄺ	솱
ㅅㅘㄻ	솲
ㅅㅘㄼ	솳
ㅅㅘㄽ	솴
ㅅㅘㄾ	솵
ㅅㅘㄿ	솶
ㅅㅘㅀ	솷
ㅅㅘㅁ	솸
ㅅㅘㅂ	솹
ㅅㅘㅄ	솺
ㅅㅘㅅ	솻
ㅅㅘㅆ	솼
ㅅㅘㅇ	솽
ㅅㅘㅈ	솾
ㅅㅘㅊ	솿
ㅅㅘㅋ	쇀
ㅅㅘㅌ	쇁
ㅅㅘㅍ	쇂
ㅅㅘㅎ	쇃
ㅅㅙ	쇄
ㅅㅙㄱ	쇅
ㅅㅙㄲ	쇆
ㅅㅙㄳ	쇇
ㅅㅙㄴ	쇈
ㅅㅙㄵ	쇉
ㅅㅙㄶ	쇊
ㅅㅙㄷ	쇋
ㅅㅙㄹ	쇌
ㅅㅙㄺ	쇍
ㅅㅙㄻ	쇎
ㅅㅙㄼ	쇏
ㅅㅙㄽ	쇐
ㅅㅙㄾ	쇑
ㅅㅙㄿ	쇒
ㅅㅙㅀ	쇓
ㅅㅙㅁ	쇔
ㅅㅙㅂ	쇕
ㅅㅙㅄ	쇖
ㅅㅙㅅ	쇗
ㅅㅙㅆ	쇘
ㅅㅙㅇ	쇙
ㅅㅙㅈ	쇚
ㅅㅙㅊ	쇛
ㅅㅙㅋ	쇜
ㅅㅙㅌ	쇝
ㅅㅙㅍ	쇞
ㅅㅙㅎ	쇟
ㅅㅚ	쇠
ㅅㅚㄱ	쇡
ㅅㅚㄲ	쇢
ㅅㅚㄳ	쇣
ㅅㅚㄴ	쇤
ㅅㅚㄵ	쇥
ㅅㅚㄶ	쇦
ㅅㅚㄷ	쇧
ㅅㅚㄹ	쇨
ㅅㅚㄺ	쇩
ㅅㅚㄻ	쇪
ㅅㅚㄼ	쇫
ㅅㅚㄽ	쇬
ㅅㅚㄾ	쇭
ㅅㅚㄿ	쇮
ㅅㅚㅀ	쇯
ㅅㅚㅁ	쇰
ㅅㅚㅂ	쇱
ㅅㅚㅄ	쇲
ㅅㅚㅅ	쇳
ㅅㅚㅆ	쇴
ㅅㅚㅇ	쇵
ㅅㅚㅈ	쇶
ㅅㅚㅊ	쇷
ㅅㅚㅋ	쇸
ㅅㅚㅌ	쇹
ㅅㅚㅍ	쇺
ㅅㅚㅎ	쇻
ㅅㅛ	쇼
ㅅㅛㄱ	쇽
ㅅㅛㄲ	쇾
ㅅㅛㄳ	쇿
ㅅㅛㄴ	숀
ㅅㅛㄵ	숁
ㅅㅛㄶ	숂
ㅅㅛㄷ	숃
ㅅㅛㄹ	숄
ㅅㅛㄺ	숅
ㅅㅛㄻ	숆
ㅅㅛㄼ	숇
ㅅㅛㄽ	숈
ㅅㅛㄾ	숉
ㅅㅛㄿ	숊
ㅅㅛㅀ	숋
ㅅㅛㅁ	숌
ㅅㅛㅂ	숍
ㅅㅛㅄ	숎
ㅅㅛㅅ	숏
ㅅㅛㅆ	숐
ㅅㅛㅇ	숑
ㅅㅛㅈ	숒
ㅅㅛㅊ	숓
ㅅㅛㅋ	숔
ㅅㅛㅌ	숕
ㅅㅛㅍ	숖
ㅅㅛㅎ	숗
ㅅㅜ	수
ㅅㅜㄱ	숙
ㅅㅜㄲ	숚
ㅅㅜㄳ	숛
ㅅㅜㄴ	순
ㅅㅜㄵ	숝
ㅅㅜㄶ	숞
ㅅㅜㄷ	숟
ㅅㅜㄹ	술
ㅅㅜㄺ	숡
ㅅㅜㄻ	숢
ㅅㅜㄼ	숣
ㅅㅜㄽ	숤
ㅅㅜㄾ	숥
ㅅㅜㄿ	숦
ㅅㅜㅀ	숧
ㅅㅜㅁ	숨
ㅅㅜㅂ	숩
ㅅㅜㅄ	숪
ㅅㅜㅅ	숫
ㅅㅜㅆ	숬
ㅅㅜㅇ	숭
ㅅㅜㅈ	숮
ㅅㅜㅊ	숯
ㅅㅜㅋ	숰
ㅅㅜㅌ	숱
ㅅㅜㅍ	숲
ㅅㅜㅎ	숳
ㅅㅝ	숴
ㅅㅝㄱ	숵
ㅅㅝㄲ	숶
ㅅㅝㄳ	숷
ㅅㅝㄴ	숸
ㅅㅝㄵ	숹
ㅅㅝㄶ	숺
ㅅㅝㄷ	숻
ㅅㅝㄹ	숼
ㅅㅝㄺ	숽
ㅅㅝㄻ	숾
ㅅㅝㄼ	숿
ㅅㅝㄽ	쉀
ㅅㅝㄾ	쉁
ㅅㅝㄿ	쉂
ㅅㅝㅀ	쉃
ㅅㅝㅁ	쉄
ㅅㅝㅂ	쉅
ㅅㅝㅄ	쉆
ㅅㅝㅅ	쉇
ㅅㅝㅆ	쉈
ㅅㅝㅇ	쉉
ㅅㅝㅈ	쉊
ㅅㅝㅊ	쉋
ㅅㅝㅋ	쉌
ㅅㅝㅌ	쉍
ㅅㅝㅍ	쉎
ㅅㅝㅎ	쉏
ㅅㅞ	쉐
ㅅㅞㄱ	쉑
ㅅㅞㄲ	쉒
ㅅㅞㄳ	쉓
ㅅㅞㄴ	쉔
ㅅㅞㄵ	쉕
ㅅㅞㄶ	쉖
ㅅㅞㄷ	쉗
ㅅㅞㄹ	쉘
ㅅㅞㄺ	쉙
ㅅㅞㄻ	쉚
ㅅㅞㄼ	쉛
ㅅㅞㄽ	쉜
ㅅㅞㄾ	쉝
ㅅㅞㄿ	쉞
ㅅㅞㅀ	쉟
ㅅㅞㅁ	쉠
ㅅㅞㅂ	쉡
ㅅㅞㅄ	쉢
ㅅㅞㅅ	쉣
ㅅㅞㅆ	쉤
ㅅㅞㅇ	쉥
ㅅㅞㅈ	쉦
ㅅㅞㅊ	쉧
ㅅㅞㅋ	쉨
ㅅㅞㅌ	쉩
ㅅㅞㅍ	쉪
ㅅㅞㅎ	쉫
ㅅㅟ	쉬
ㅅㅟㄱ	쉭
ㅅㅟㄲ	쉮
ㅅㅟㄳ	쉯
ㅅㅟㄴ	쉰
ㅅㅟㄵ	쉱
ㅅㅟㄶ	쉲
ㅅㅟㄷ	쉳
ㅅㅟㄹ	쉴
ㅅㅟㄺ	쉵
ㅅㅟㄻ	쉶
ㅅㅟㄼ	쉷
ㅅㅟㄽ	쉸
ㅅㅟㄾ	쉹
ㅅㅟㄿ	쉺
ㅅㅟㅀ	쉻
ㅅㅟㅁ	쉼
ㅅㅟㅂ	쉽
ㅅㅟㅄ	쉾
ㅅㅟㅅ	쉿
ㅅㅟㅆ	슀
ㅅㅟㅇ	슁
ㅅㅟㅈ	슂
ㅅㅟㅊ	슃
ㅅㅟㅋ	슄
ㅅㅟㅌ	슅
ㅅㅟㅍ	슆
ㅅㅟㅎ	슇
ㅅㅠ	슈
ㅅㅠㄱ	슉
ㅅㅠㄲ	슊
ㅅㅠㄳ	슋
ㅅㅠㄴ	슌
ㅅㅠㄵ	슍
ㅅㅠㄶ	슎
ㅅㅠㄷ	슏
ㅅㅠㄹ	슐
ㅅㅠㄺ	슑
ㅅㅠㄻ	슒
ㅅㅠㄼ	슓
ㅅㅠㄽ	슔
ㅅㅠㄾ	슕
ㅅㅠㄿ	슖
ㅅㅠㅀ	슗
ㅅㅠㅁ	슘
ㅅㅠㅂ	슙
ㅅㅠㅄ	슚
ㅅㅠㅅ	슛
ㅅㅠㅆ	슜
ㅅㅠㅇ	슝
ㅅㅠㅈ	슞
ㅅㅠㅊ	슟
ㅅㅠㅋ	슠
ㅅㅠㅌ	슡
ㅅㅠㅍ	슢
ㅅㅠㅎ	슣
ㅅㅡ	스
ㅅㅡㄱ	슥
ㅅㅡㄲ	슦
ㅅㅡㄳ	슧
ㅅㅡㄴ	슨
ㅅㅡㄵ	슩
ㅅㅡㄶ	슪
ㅅㅡㄷ	슫
ㅅㅡㄹ	슬
ㅅㅡㄺ	슭
ㅅㅡㄻ	슮
ㅅㅡㄼ	슯
ㅅㅡㄽ	슰
ㅅㅡㄾ	슱
ㅅㅡㄿ	슲
ㅅㅡㅀ	슳
ㅅㅡㅁ	슴
ㅅㅡㅂ	습
ㅅㅡㅄ	슶
ㅅㅡㅅ	슷
ㅅㅡㅆ	슸
ㅅㅡㅇ	승
ㅅㅡㅈ	슺
ㅅㅡㅊ	슻
ㅅㅡㅋ	슼
ㅅㅡㅌ	슽
ㅅㅡㅍ	슾
ㅅㅡㅎ	슿
ㅅㅢ	싀
ㅅㅢㄱ	싁
ㅅㅢㄲ	싂
ㅅㅢㄳ	싃
ㅅㅢㄴ	싄
ㅅㅢㄵ	싅
ㅅㅢㄶ	싆
ㅅㅢㄷ	싇
ㅅㅢㄹ	싈
ㅅㅢㄺ	싉
ㅅㅢㄻ	싊
ㅅㅢㄼ	싋
ㅅㅢㄽ	싌
ㅅㅢㄾ	싍
ㅅㅢㄿ	싎
ㅅㅢㅀ	싏
ㅅㅢㅁ	싐
ㅅㅢㅂ	싑
ㅅㅢㅄ	싒
ㅅㅢㅅ	싓
ㅅㅢㅆ	싔
ㅅㅢㅇ	싕
ㅅㅢㅈ	싖
ㅅㅢㅊ	싗
ㅅㅢㅋ	싘
ㅅㅢㅌ	싙
ㅅㅢㅍ	싚
ㅅㅢㅎ	싛
ㅅㅣ	시
ㅅㅣㄱ	식
ㅅㅣㄲ	싞
ㅅㅣㄳ	싟
ㅅㅣㄴ	신
ㅅㅣㄵ	싡
ㅅㅣㄶ	싢
ㅅㅣㄷ	싣
ㅅㅣㄹ	실
ㅅㅣㄺ	싥
ㅅㅣㄻ	싦
ㅅㅣㄼ	싧
ㅅㅣㄽ	싨
ㅅㅣㄾ	싩
ㅅㅣㄿ	싪
ㅅㅣㅀ	싫
ㅅㅣㅁ	심
ㅅㅣㅂ	십
ㅅㅣㅄ	싮
ㅅㅣㅅ	싯
ㅅㅣㅆ	싰
ㅅㅣㅇ	싱
ㅅㅣㅈ	싲
ㅅㅣㅊ	싳
ㅅㅣㅋ	싴
ㅅㅣㅌ	싵
ㅅㅣㅍ	싶
ㅅㅣㅎ	싷
ㅆㅏ	싸
ㅆㅏㄱ	싹
ㅆㅏㄲ	싺
ㅆㅏㄳ	싻
ㅆㅏㄴ	싼
ㅆㅏㄵ	싽
ㅆㅏㄶ	싾
ㅆㅏㄷ	싿
ㅆㅏㄹ	쌀
ㅆㅏㄺ	쌁
ㅆㅏㄻ	쌂
ㅆㅏㄼ	쌃
ㅆㅏㄽ	쌄
ㅆㅏㄾ	쌅
ㅆㅏㄿ	쌆
ㅆㅏㅀ	쌇
ㅆㅏㅁ	쌈
ㅆㅏㅂ	쌉
ㅆㅏㅄ	쌊
ㅆㅏㅅ	쌋
ㅆㅏㅆ	쌌
ㅆㅏㅇ	쌍
ㅆㅏㅈ	쌎
ㅆㅏㅊ	쌏
ㅆㅏㅋ	쌐
ㅆㅏㅌ	쌑
ㅆㅏㅍ	쌒
ㅆㅏㅎ	쌓
ㅆㅐ	쌔
ㅆㅐㄱ	쌕
ㅆㅐㄲ	쌖
ㅆㅐㄳ	쌗
ㅆㅐㄴ	쌘
ㅆㅐㄵ	쌙
ㅆㅐㄶ	쌚
ㅆㅐㄷ	쌛
ㅆㅐㄹ	쌜
ㅆㅐㄺ	쌝
ㅆㅐㄻ	쌞
ㅆㅐㄼ	쌟
ㅆㅐㄽ	쌠
ㅆㅐㄾ	쌡
ㅆㅐㄿ	쌢
ㅆㅐㅀ	쌣
ㅆㅐㅁ	쌤
ㅆㅐㅂ	쌥
ㅆㅐㅄ	쌦
ㅆㅐㅅ	쌧
ㅆㅐㅆ	쌨
ㅆㅐㅇ	쌩
ㅆㅐㅈ	쌪
ㅆㅐㅊ	쌫
ㅆㅐㅋ	쌬
ㅆㅐㅌ	쌭
ㅆㅐㅍ	쌮
ㅆㅐㅎ	쌯
ㅆㅑ	쌰
ㅆㅑㄱ	쌱
ㅆㅑㄲ	쌲
ㅆㅑㄳ	쌳
ㅆㅑㄴ	쌴
ㅆㅑㄵ	쌵
ㅆㅑㄶ	쌶
ㅆㅑㄷ	쌷
ㅆㅑㄹ	쌸
ㅆㅑㄺ	쌹
ㅆㅑㄻ	쌺
ㅆㅑㄼ	쌻
ㅆㅑㄽ	쌼
ㅆㅑㄾ	쌽
ㅆㅑㄿ	쌾
ㅆㅑㅀ	쌿
ㅆㅑㅁ	썀
ㅆㅑㅂ	썁
ㅆㅑㅄ	썂
ㅆㅑㅅ	썃
ㅆㅑㅆ	썄
ㅆㅑㅇ	썅
ㅆㅑㅈ	썆
ㅆㅑㅊ	썇
ㅆㅑㅋ	썈
ㅆㅑㅌ	썉
ㅆㅑㅍ	썊
ㅆㅑㅎ	썋
ㅆㅒ	썌
ㅆㅒㄱ	썍
ㅆㅒㄲ	썎
ㅆㅒㄳ	썏
ㅆㅒㄴ	썐
ㅆㅒㄵ	썑
ㅆㅒㄶ	썒
ㅆㅒㄷ	썓
ㅆㅒㄹ	썔
ㅆㅒㄺ	썕
ㅆㅒㄻ	썖
ㅆㅒㄼ	썗
ㅆㅒㄽ	썘
ㅆㅒㄾ	썙
ㅆㅒㄿ	썚
ㅆㅒㅀ	썛
ㅆㅒㅁ	썜
ㅆㅒㅂ	썝
ㅆㅒㅄ	썞
ㅆㅒㅅ	썟
ㅆㅒㅆ	썠
ㅆㅒㅇ	썡
ㅆㅒㅈ	썢
ㅆㅒㅊ	썣
ㅆㅒㅋ	썤
ㅆㅒㅌ	썥
ㅆㅒㅍ	썦
ㅆㅒㅎ	썧
ㅆㅓ	써
ㅆㅓㄱ	썩
ㅆㅓㄲ	썪
ㅆㅓㄳ	썫
ㅆㅓㄴ	썬
ㅆㅓㄵ	썭
ㅆㅓㄶ	썮
ㅆㅓㄷ	썯
ㅆㅓㄹ	썰
ㅆㅓㄺ	썱
ㅆㅓㄻ	썲
ㅆㅓㄼ	썳
ㅆㅓㄽ	썴
ㅆㅓㄾ	썵
ㅆㅓㄿ	썶
ㅆㅓㅀ	썷
ㅆㅓㅁ	썸
ㅆㅓㅂ	썹
ㅆㅓㅄ	썺
ㅆㅓㅅ	썻
ㅆㅓㅆ	썼
ㅆㅓㅇ	썽
ㅆㅓㅈ	썾
ㅆㅓㅊ	썿
ㅆㅓㅋ	쎀
ㅆㅓㅌ	쎁
ㅆㅓㅍ	쎂
ㅆㅓㅎ	쎃
ㅆㅔ	쎄
ㅆㅔㄱ	쎅
ㅆㅔㄲ	쎆
ㅆㅔㄳ	쎇
ㅆㅔㄴ	쎈
ㅆㅔㄵ	쎉
ㅆㅔㄶ	쎊
ㅆㅔㄷ	쎋
ㅆㅔㄹ	쎌
ㅆㅔㄺ	쎍
ㅆㅔㄻ	쎎
ㅆㅔㄼ	쎏
ㅆㅔㄽ	쎐
ㅆㅔㄾ	쎑
ㅆㅔㄿ	쎒
ㅆㅔㅀ	쎓
ㅆㅔㅁ	쎔
ㅆㅔㅂ	쎕
ㅆㅔㅄ	쎖
ㅆㅔㅅ	쎗
ㅆㅔㅆ	쎘
ㅆㅔㅇ	쎙
ㅆㅔㅈ	쎚
ㅆㅔㅊ	쎛
ㅆㅔㅋ	쎜
ㅆㅔㅌ	쎝
ㅆㅔㅍ	쎞
ㅆㅔㅎ	쎟
ㅆㅕ	쎠
ㅆㅕㄱ	쎡
ㅆㅕㄲ	쎢
ㅆㅕㄳ	쎣
ㅆㅕㄴ	쎤
ㅆㅕㄵ	쎥
ㅆㅕㄶ	쎦
ㅆㅕㄷ	쎧
ㅆㅕㄹ	쎨
ㅆㅕㄺ	쎩
ㅆㅕㄻ	쎪
ㅆㅕㄼ	쎫
ㅆㅕㄽ	쎬
ㅆㅕㄾ	쎭
ㅆㅕㄿ	쎮
ㅆㅕㅀ	쎯
ㅆㅕㅁ	쎰
ㅆㅕㅂ	쎱
ㅆㅕㅄ	쎲
ㅆㅕㅅ	쎳
ㅆㅕㅆ	쎴
ㅆㅕㅇ	쎵
ㅆㅕㅈ	쎶
ㅆㅕㅊ	쎷
ㅆㅕㅋ	쎸
ㅆㅕㅌ	쎹
ㅆㅕㅍ	쎺
ㅆㅕㅎ	쎻
ㅆㅖ	쎼
ㅆㅖㄱ	쎽
ㅆㅖㄲ	쎾
ㅆㅖㄳ	쎿
ㅆㅖㄴ	쏀
ㅆㅖㄵ	쏁
ㅆㅖㄶ	쏂
ㅆㅖㄷ	쏃
ㅆㅖㄹ	쏄
ㅆㅖㄺ	쏅
ㅆㅖㄻ	쏆
ㅆㅖㄼ	쏇
ㅆㅖㄽ	쏈
ㅆㅖㄾ	쏉
ㅆㅖㄿ	쏊
ㅆㅖㅀ	쏋
ㅆㅖㅁ	쏌
ㅆㅖㅂ	쏍
ㅆㅖㅄ	쏎
ㅆㅖㅅ	쏏
ㅆㅖㅆ	쏐
ㅆㅖㅇ	쏑
ㅆㅖㅈ	쏒
ㅆㅖㅊ	쏓
ㅆㅖㅋ	쏔
ㅆㅖㅌ	쏕
ㅆㅖㅍ	쏖
ㅆㅖㅎ	쏗
ㅆㅗ	쏘
ㅆㅗㄱ	쏙
ㅆㅗㄲ	쏚
ㅆㅗㄳ	쏛
ㅆㅗㄴ	쏜
ㅆㅗㄵ	쏝
ㅆㅗㄶ	쏞
ㅆㅗㄷ	쏟
ㅆㅗㄹ	쏠
ㅆㅗㄺ	쏡
ㅆㅗㄻ	쏢
ㅆㅗㄼ	쏣
ㅆㅗㄽ	쏤
ㅆㅗㄾ	쏥
ㅆㅗㄿ	쏦
ㅆㅗㅀ	쏧
ㅆㅗㅁ	쏨
ㅆㅗㅂ	쏩
ㅆㅗㅄ	쏪
ㅆㅗㅅ	쏫
ㅆㅗㅆ	쏬
ㅆㅗㅇ	쏭
ㅆㅗㅈ	쏮
ㅆㅗㅊ	쏯
ㅆㅗㅋ	쏰
ㅆㅗㅌ	쏱
ㅆㅗㅍ	쏲
ㅆㅗㅎ	쏳
ㅆㅘ	쏴
ㅆㅘㄱ	쏵
ㅆㅘㄲ	쏶
ㅆㅘㄳ	쏷
ㅆㅘㄴ	쏸
ㅆㅘㄵ	쏹
ㅆㅘㄶ	쏺
ㅆㅘㄷ	쏻
ㅆㅘㄹ	쏼
ㅆㅘㄺ	쏽
ㅆㅘㄻ	쏾
ㅆㅘㄼ	쏿
ㅆㅘㄽ	쐀
ㅆㅘㄾ	쐁
ㅆㅘㄿ	쐂
ㅆㅘㅀ	쐃
ㅆㅘㅁ	쐄
ㅆㅘㅂ	쐅
ㅆㅘㅄ	쐆
ㅆㅘㅅ	쐇
ㅆㅘㅆ	쐈
ㅆㅘㅇ	쐉
ㅆㅘㅈ	쐊
ㅆㅘㅊ	쐋
ㅆㅘㅋ	쐌
ㅆㅘㅌ	쐍
ㅆㅘㅍ	쐎
ㅆㅘㅎ	쐏
ㅆㅙ	쐐
ㅆㅙㄱ	쐑
ㅆㅙㄲ	쐒
ㅆㅙㄳ	쐓
ㅆㅙㄴ	쐔
ㅆㅙㄵ	쐕
ㅆㅙㄶ	쐖
ㅆㅙㄷ	쐗
ㅆㅙㄹ	쐘
ㅆㅙㄺ	쐙
ㅆㅙㄻ	쐚
ㅆㅙㄼ	쐛
ㅆㅙㄽ	쐜
ㅆㅙㄾ	쐝
ㅆㅙㄿ	쐞
ㅆㅙㅀ	쐟
ㅆㅙㅁ	쐠
ㅆㅙㅂ	쐡
ㅆㅙㅄ	쐢
ㅆㅙㅅ	쐣
ㅆㅙㅆ	쐤
ㅆㅙㅇ	쐥
ㅆㅙㅈ	쐦
ㅆㅙㅊ	쐧
ㅆㅙㅋ	쐨
ㅆㅙㅌ	쐩
ㅆㅙㅍ	쐪
ㅆㅙㅎ	쐫
ㅆㅚ	쐬
ㅆㅚㄱ	쐭
ㅆㅚㄲ	쐮
ㅆㅚㄳ	쐯
ㅆㅚㄴ	쐰
ㅆㅚㄵ	쐱
ㅆㅚㄶ	쐲
ㅆㅚㄷ	쐳
ㅆㅚㄹ	쐴
ㅆㅚㄺ	쐵
ㅆㅚㄻ	쐶
ㅆㅚㄼ	쐷
ㅆㅚㄽ	쐸
ㅆㅚㄾ	쐹
ㅆㅚㄿ	쐺
ㅆㅚㅀ	쐻
ㅆㅚㅁ	쐼
ㅆㅚㅂ	쐽
ㅆㅚㅄ	쐾
ㅆㅚㅅ	쐿
ㅆㅚㅆ	쑀
ㅆㅚㅇ	쑁
ㅆㅚㅈ	쑂
ㅆㅚㅊ	쑃
ㅆㅚㅋ	쑄
ㅆㅚㅌ	쑅
ㅆㅚㅍ	쑆
ㅆㅚㅎ	쑇
ㅆㅛ	쑈
ㅆㅛㄱ	쑉
ㅆㅛㄲ	쑊
ㅆㅛㄳ	쑋
ㅆㅛㄴ	쑌
ㅆㅛㄵ	쑍
ㅆㅛㄶ	쑎
ㅆㅛㄷ	쑏
ㅆㅛㄹ	쑐
ㅆㅛㄺ	쑑
ㅆㅛㄻ	쑒
ㅆㅛㄼ	쑓
ㅆㅛㄽ	쑔
ㅆㅛㄾ	쑕
ㅆㅛㄿ	쑖
ㅆㅛㅀ	쑗
ㅆㅛㅁ	쑘
ㅆㅛㅂ	쑙
ㅆㅛㅄ	쑚
ㅆㅛㅅ	쑛
ㅆㅛㅆ	쑜
ㅆㅛㅇ	쑝
ㅆㅛㅈ	쑞
ㅆㅛㅊ	쑟
ㅆㅛㅋ	쑠
ㅆㅛㅌ	쑡
ㅆㅛㅍ	쑢
ㅆㅛㅎ	쑣
ㅆㅜ	쑤
ㅆㅜㄱ	쑥
ㅆㅜㄲ	쑦
ㅆㅜㄳ	쑧
ㅆㅜㄴ	쑨
ㅆㅜㄵ	쑩
ㅆㅜㄶ	쑪
ㅆㅜㄷ	쑫
ㅆㅜㄹ	쑬
ㅆㅜㄺ	쑭
ㅆㅜㄻ	쑮
ㅆㅜㄼ	쑯
ㅆㅜㄽ	쑰
ㅆㅜㄾ	쑱
ㅆㅜㄿ	쑲
ㅆㅜㅀ	쑳
ㅆㅜㅁ	쑴
ㅆㅜㅂ	쑵
ㅆㅜㅄ	쑶
ㅆㅜㅅ	쑷
ㅆㅜㅆ	쑸
ㅆㅜㅇ	쑹
ㅆㅜㅈ	쑺
ㅆㅜㅊ	쑻
ㅆㅜㅋ	쑼
ㅆㅜㅌ	쑽
ㅆㅜㅍ	쑾
ㅆㅜㅎ	쑿
ㅆㅝ	쒀
ㅆㅝㄱ	쒁
ㅆㅝㄲ	쒂
ㅆㅝㄳ	쒃
ㅆㅝㄴ	쒄
ㅆㅝㄵ	쒅
ㅆㅝㄶ	쒆
ㅆㅝㄷ	쒇
ㅆㅝㄹ	쒈
ㅆㅝㄺ	쒉
ㅆㅝㄻ	쒊
ㅆㅝㄼ	쒋
ㅆㅝㄽ	쒌
ㅆㅝㄾ	쒍
ㅆㅝㄿ	쒎
ㅆㅝㅀ	쒏
ㅆㅝㅁ	쒐
ㅆㅝㅂ	쒑
ㅆㅝㅄ	쒒
ㅆㅝㅅ	쒓
ㅆㅝㅆ	쒔
ㅆㅝㅇ	쒕
ㅆㅝㅈ	쒖
ㅆㅝㅊ	쒗
ㅆㅝㅋ	쒘
ㅆㅝㅌ	쒙
ㅆㅝㅍ	쒚
ㅆㅝㅎ	쒛
ㅆㅞ	쒜
ㅆㅞㄱ	쒝
ㅆㅞㄲ	쒞
ㅆㅞㄳ	쒟
ㅆㅞㄴ	쒠
ㅆㅞㄵ	쒡
ㅆㅞㄶ	쒢
ㅆㅞㄷ	쒣
ㅆㅞㄹ	쒤
ㅆㅞㄺ	쒥
ㅆㅞㄻ	쒦
ㅆㅞㄼ	쒧
ㅆㅞㄽ	쒨
ㅆㅞㄾ	쒩
ㅆㅞㄿ	쒪
ㅆㅞㅀ	쒫
ㅆㅞㅁ	쒬
ㅆㅞㅂ	쒭
ㅆㅞㅄ	쒮
ㅆㅞㅅ	쒯
ㅆㅞㅆ	쒰
ㅆㅞㅇ	쒱
ㅆㅞㅈ	쒲
ㅆㅞㅊ	쒳
ㅆㅞㅋ	쒴
ㅆㅞㅌ	쒵
ㅆㅞㅍ	쒶
ㅆㅞㅎ	쒷
ㅆㅟ	쒸
ㅆㅟㄱ	쒹
ㅆㅟㄲ	쒺
ㅆㅟㄳ	쒻
ㅆㅟㄴ	쒼
ㅆㅟㄵ	쒽
ㅆㅟㄶ	쒾
ㅆㅟㄷ	쒿
ㅆㅟㄹ	쓀
ㅆㅟㄺ	쓁
ㅆㅟㄻ	쓂
ㅆㅟㄼ	쓃
ㅆㅟㄽ	쓄
ㅆㅟㄾ	쓅
ㅆㅟㄿ	쓆
ㅆㅟㅀ	쓇
ㅆㅟㅁ	쓈
ㅆㅟㅂ	쓉
ㅆㅟㅄ	쓊
ㅆㅟㅅ	쓋
ㅆㅟㅆ	쓌
ㅆㅟㅇ	쓍
ㅆㅟㅈ	쓎
ㅆㅟㅊ	쓏
ㅆㅟㅋ	쓐
ㅆㅟㅌ	쓑
ㅆㅟㅍ	쓒
ㅆㅟㅎ	쓓
ㅆㅠ	쓔
ㅆㅠㄱ	쓕
ㅆㅠㄲ	쓖
ㅆㅠㄳ	쓗
ㅆㅠㄴ	쓘
ㅆㅠㄵ	쓙
ㅆㅠㄶ	쓚
ㅆㅠㄷ	쓛
ㅆㅠㄹ	쓜
ㅆㅠㄺ	쓝
ㅆㅠㄻ	쓞
ㅆㅠㄼ	쓟
ㅆㅠㄽ	쓠
ㅆㅠㄾ	쓡
ㅆㅠㄿ	쓢
ㅆㅠㅀ	쓣
ㅆㅠㅁ	쓤
ㅆㅠㅂ	쓥
ㅆㅠㅄ	쓦
ㅆㅠㅅ	쓧
ㅆㅠㅆ	쓨
ㅆㅠㅇ	쓩
ㅆㅠㅈ	쓪
ㅆㅠㅊ	쓫
ㅆㅠㅋ	쓬
ㅆㅠㅌ	쓭
ㅆㅠㅍ	쓮
ㅆㅠㅎ	쓯
ㅆㅡ	쓰
ㅆㅡㄱ	쓱
ㅆㅡㄲ	쓲
ㅆㅡㄳ	쓳
ㅆㅡㄴ	쓴
ㅆㅡㄵ	쓵
ㅆㅡㄶ	쓶
ㅆㅡㄷ	쓷
ㅆㅡㄹ	쓸
ㅆㅡㄺ	쓹
ㅆㅡㄻ	쓺
ㅆㅡㄼ	쓻
ㅆㅡㄽ	쓼
ㅆㅡㄾ	쓽
ㅆㅡㄿ	쓾
ㅆㅡㅀ	쓿
ㅆㅡㅁ	씀
ㅆㅡㅂ	씁
ㅆㅡㅄ	씂
ㅆㅡㅅ	씃
ㅆㅡㅆ	씄
ㅆㅡㅇ	씅
ㅆㅡㅈ	씆
ㅆㅡㅊ	씇
ㅆㅡㅋ	씈
ㅆㅡㅌ	씉
ㅆㅡㅍ	씊
ㅆㅡㅎ	씋
ㅆㅢ	씌
ㅆㅢㄱ	씍
ㅆㅢㄲ	씎
ㅆㅢㄳ	씏
ㅆㅢㄴ	씐
ㅆㅢㄵ	씑
ㅆㅢㄶ	씒
ㅆㅢㄷ	씓
ㅆㅢㄹ	씔
ㅆㅢㄺ	씕
ㅆㅢㄻ	씖
ㅆㅢㄼ	씗
ㅆㅢㄽ	씘
ㅆㅢㄾ	씙
ㅆㅢㄿ	씚
ㅆㅢㅀ	씛
ㅆㅢㅁ	씜
ㅆㅢㅂ	씝
ㅆㅢㅄ	씞
ㅆㅢㅅ	씟
ㅆㅢㅆ	씠
ㅆㅢㅇ	씡
ㅆㅢㅈ	씢
ㅆㅢㅊ	씣
ㅆㅢㅋ	씤
ㅆㅢㅌ	씥
ㅆㅢㅍ	씦
ㅆㅢㅎ	씧
ㅆㅣ	씨
ㅆㅣㄱ	씩
ㅆㅣㄲ	씪
ㅆㅣㄳ	씫
ㅆㅣㄴ	씬
ㅆㅣㄵ	씭
ㅆㅣㄶ	씮
ㅆㅣㄷ	씯
ㅆㅣㄹ	씰
ㅆㅣㄺ	씱
ㅆㅣㄻ	씲
ㅆㅣㄼ	씳
ㅆㅣㄽ	씴
ㅆㅣㄾ	씵
ㅆㅣㄿ	씶
ㅆㅣㅀ	씷
ㅆㅣㅁ	씸
ㅆㅣㅂ	씹
ㅆㅣㅄ	씺
ㅆㅣㅅ	씻
ㅆㅣㅆ	씼
ㅆㅣㅇ	씽
ㅆㅣㅈ	씾
ㅆㅣㅊ	씿
ㅆㅣㅋ	앀
ㅆㅣㅌ	앁
ㅆㅣㅍ	앂
ㅆㅣㅎ	앃
ㅇㅏ	아
ㅇㅏㄱ	악
ㅇㅏㄲ	앆
ㅇㅏㄳ	앇
ㅇㅏㄴ	안
ㅇㅏㄵ	앉
ㅇㅏㄶ	않
ㅇㅏㄷ	앋
ㅇㅏㄹ	알
ㅇㅏㄺ	앍
ㅇㅏㄻ	앎
ㅇㅏㄼ	앏
ㅇㅏㄽ	앐
ㅇㅏㄾ	앑
ㅇㅏㄿ	앒
ㅇㅏㅀ	앓
ㅇㅏㅁ	암
ㅇㅏㅂ	압
ㅇㅏㅄ	앖
ㅇㅏㅅ	앗
ㅇㅏㅆ	았
ㅇㅏㅇ	앙
ㅇㅏㅈ	앚
ㅇㅏㅊ	앛
ㅇㅏㅋ	앜
ㅇㅏㅌ	앝
ㅇㅏㅍ	앞
ㅇㅏㅎ	앟
ㅇㅐ	애
ㅇㅐㄱ	액
ㅇㅐㄲ	앢
ㅇㅐㄳ	앣
ㅇㅐㄴ	앤
ㅇㅐㄵ	앥
ㅇㅐㄶ	앦
ㅇㅐㄷ	앧
ㅇㅐㄹ	앨
ㅇㅐㄺ	앩
ㅇㅐㄻ	앪
ㅇㅐㄼ	앫
ㅇㅐㄽ	앬
ㅇㅐㄾ	앭
ㅇㅐㄿ	앮
ㅇㅐㅀ	앯
ㅇㅐㅁ	앰
ㅇㅐㅂ	앱
ㅇㅐㅄ	앲
ㅇㅐㅅ	앳
ㅇㅐㅆ	앴
ㅇㅐㅇ	앵
ㅇㅐㅈ	앶
ㅇㅐㅊ	앷
ㅇㅐㅋ	앸
ㅇㅐㅌ	앹
ㅇㅐㅍ	앺
ㅇㅐㅎ	앻
ㅇㅑ	야
ㅇㅑㄱ	약
ㅇㅑㄲ	앾
ㅇㅑㄳ	앿
ㅇㅑㄴ	얀
ㅇㅑㄵ	얁
ㅇㅑㄶ	얂
ㅇㅑㄷ	얃
ㅇㅑㄹ	얄
ㅇㅑㄺ	얅
ㅇㅑㄻ	얆
ㅇㅑㄼ	얇
ㅇㅑㄽ	얈
ㅇㅑㄾ	얉
ㅇㅑㄿ	얊
ㅇㅑㅀ	얋
ㅇㅑㅁ	얌
ㅇㅑㅂ	얍
ㅇㅑㅄ	얎
ㅇㅑㅅ	얏
ㅇㅑㅆ	얐
ㅇㅑㅇ	양
ㅇㅑㅈ	얒
ㅇㅑㅊ	얓
ㅇㅑㅋ	얔
ㅇㅑㅌ	얕
ㅇㅑㅍ	얖
ㅇㅑㅎ	얗
ㅇㅒ	얘
ㅇㅒㄱ	얙
ㅇㅒㄲ	얚
ㅇㅒㄳ	얛
ㅇㅒㄴ	얜
ㅇㅒㄵ	얝
ㅇㅒㄶ	얞
ㅇㅒㄷ	얟
ㅇㅒㄹ	얠
ㅇㅒㄺ	얡
ㅇㅒㄻ	얢
ㅇㅒㄼ	얣
ㅇㅒㄽ	얤
ㅇㅒㄾ	얥
ㅇㅒㄿ	얦
ㅇㅒㅀ	얧
ㅇㅒㅁ	얨
ㅇㅒㅂ	얩
ㅇㅒㅄ	얪
ㅇㅒㅅ	얫
ㅇㅒㅆ	얬
ㅇㅒㅇ	얭
ㅇㅒㅈ	얮
ㅇㅒㅊ	얯
ㅇㅒㅋ	얰
ㅇㅒㅌ	얱
ㅇㅒㅍ	얲
ㅇㅒㅎ	얳
ㅇㅓ	어
ㅇㅓㄱ	억
ㅇㅓㄲ	얶
ㅇㅓㄳ	얷
ㅇㅓㄴ	언
ㅇㅓㄵ	얹
ㅇㅓㄶ	얺
ㅇㅓㄷ	얻
ㅇㅓㄹ	얼
ㅇㅓㄺ	얽
ㅇㅓㄻ	얾
ㅇㅓㄼ	얿
ㅇㅓㄽ	엀
ㅇㅓㄾ	엁
ㅇㅓㄿ	엂
ㅇㅓㅀ	엃
ㅇㅓㅁ	엄
ㅇㅓㅂ	업
ㅇㅓㅄ	없
ㅇㅓㅅ	엇
ㅇㅓㅆ	었
ㅇㅓㅇ	엉
ㅇㅓㅈ	엊
ㅇㅓㅊ	엋
ㅇㅓㅋ	엌
ㅇㅓㅌ	엍
ㅇㅓㅍ	엎
ㅇㅓㅎ	엏
ㅇㅔ	에
ㅇㅔㄱ	엑
ㅇㅔㄲ	엒
ㅇㅔㄳ	엓
ㅇㅔㄴ	엔
ㅇㅔㄵ	엕
ㅇㅔㄶ	엖
ㅇㅔㄷ	엗
ㅇㅔㄹ	엘
ㅇㅔㄺ	엙
ㅇㅔㄻ	엚
ㅇㅔㄼ	엛
ㅇㅔㄽ	엜
ㅇㅔㄾ	엝
ㅇㅔㄿ	엞
ㅇㅔㅀ	엟
ㅇㅔㅁ	엠
ㅇㅔㅂ	엡
ㅇㅔㅄ	엢
ㅇㅔㅅ	엣
ㅇㅔㅆ	엤
ㅇㅔㅇ	엥
ㅇㅔㅈ	엦
ㅇㅔㅊ	엧
ㅇㅔㅋ	엨
ㅇㅔㅌ	엩
ㅇㅔㅍ	엪
ㅇㅔㅎ	엫
ㅇㅕ	여
ㅇㅕㄱ	역
ㅇㅕㄲ	엮
ㅇㅕㄳ	엯
ㅇㅕㄴ	연
ㅇㅕㄵ	엱
ㅇㅕㄶ	엲
ㅇㅕㄷ	엳
ㅇㅕㄹ	열
ㅇㅕㄺ	엵
ㅇㅕㄻ	엶
ㅇㅕㄼ	엷
ㅇㅕㄽ	엸
ㅇㅕㄾ	엹
ㅇㅕㄿ	엺
ㅇㅕㅀ	엻
ㅇㅕㅁ	염
ㅇㅕㅂ	엽
ㅇㅕㅄ	엾
ㅇㅕㅅ	엿
ㅇㅕㅆ	였
ㅇㅕㅇ	영
ㅇㅕㅈ	옂
ㅇㅕㅊ	옃
ㅇㅕㅋ	옄
ㅇㅕㅌ	옅
ㅇㅕㅍ	옆
ㅇㅕㅎ	옇
ㅇㅖ	예
ㅇㅖㄱ	옉
ㅇㅖㄲ	옊
ㅇㅖㄳ	옋
ㅇㅖㄴ	옌
ㅇㅖㄵ	옍
ㅇㅖㄶ	옎
ㅇㅖㄷ	옏
ㅇㅖㄹ	옐
ㅇㅖㄺ	옑
ㅇㅖㄻ	옒
ㅇㅖㄼ	옓
ㅇㅖㄽ	옔
ㅇㅖㄾ	옕
ㅇㅖㄿ	옖
ㅇㅖㅀ	옗
ㅇㅖㅁ	옘
ㅇㅖㅂ	옙
ㅇㅖㅄ	옚
ㅇㅖㅅ	옛
ㅇㅖㅆ	옜
ㅇㅖㅇ	옝
ㅇㅖㅈ	옞
ㅇㅖㅊ	옟
ㅇㅖㅋ	옠
ㅇㅖㅌ	옡
ㅇㅖㅍ	옢
ㅇㅖㅎ	옣
ㅇㅗ	오
ㅇㅗㄱ	옥
ㅇㅗㄲ	옦
ㅇㅗㄳ	옧
ㅇㅗㄴ	온
ㅇㅗㄵ	옩
ㅇㅗㄶ	옪
ㅇㅗㄷ	옫
ㅇㅗㄹ	올
ㅇㅗㄺ	옭
ㅇㅗㄻ	옮
ㅇㅗㄼ	옯
ㅇㅗㄽ	옰
ㅇㅗㄾ	옱
ㅇㅗㄿ	옲
ㅇㅗㅀ	옳
ㅇㅗㅁ	옴
ㅇㅗㅂ	옵
ㅇㅗㅄ	옶
ㅇㅗㅅ	옷
ㅇㅗㅆ	옸
ㅇㅗㅇ	옹
ㅇㅗㅈ	옺
ㅇㅗㅊ	옻
ㅇㅗㅋ	옼
ㅇㅗㅌ	옽
ㅇㅗㅍ	옾
ㅇㅗㅎ	옿
ㅇㅘ	와
ㅇㅘㄱ	왁
ㅇㅘㄲ	왂
ㅇㅘㄳ	왃
ㅇㅘㄴ	완
ㅇㅘㄵ	왅
ㅇㅘㄶ	왆
ㅇㅘㄷ	왇
ㅇㅘㄹ	왈
ㅇㅘㄺ	왉
ㅇㅘㄻ	왊
ㅇㅘㄼ	왋
ㅇㅘㄽ	왌
ㅇㅘㄾ	왍
ㅇㅘㄿ	왎
ㅇㅘㅀ	왏
ㅇㅘㅁ	왐
ㅇㅘㅂ	왑
ㅇㅘㅄ	왒
ㅇㅘㅅ	왓
ㅇㅘㅆ	왔
ㅇㅘㅇ	왕
ㅇㅘㅈ	왖
ㅇㅘㅊ	왗
ㅇㅘㅋ	왘
ㅇㅘㅌ	왙
ㅇㅘㅍ	왚
ㅇㅘㅎ	왛
ㅇㅙ	왜
ㅇㅙㄱ	왝
ㅇㅙㄲ	왞
ㅇㅙㄳ	왟
ㅇㅙㄴ	왠
ㅇㅙㄵ	왡
ㅇㅙㄶ	왢
ㅇㅙㄷ	왣
ㅇㅙㄹ	왤
ㅇㅙㄺ	왥
ㅇㅙㄻ	왦
ㅇㅙㄼ	왧
ㅇㅙㄽ	왨
ㅇㅙㄾ	왩
ㅇㅙㄿ	왪
ㅇㅙㅀ	왫
ㅇㅙㅁ	왬
ㅇㅙㅂ	왭
ㅇㅙㅄ	왮
ㅇㅙㅅ	왯
ㅇㅙㅆ	왰
ㅇㅙㅇ	왱
ㅇㅙㅈ	왲
ㅇㅙㅊ	왳
ㅇㅙㅋ	왴
ㅇㅙㅌ	왵
ㅇㅙㅍ	왶
ㅇㅙㅎ	왷
ㅇㅚ	외
ㅇㅚㄱ	왹
ㅇㅚㄲ	왺
ㅇㅚㄳ	왻
ㅇㅚㄴ	왼
ㅇㅚㄵ	왽
ㅇㅚㄶ	왾
ㅇㅚㄷ	왿
ㅇㅚㄹ	욀
ㅇㅚㄺ	욁
ㅇㅚㄻ	욂
ㅇㅚㄼ	욃
ㅇㅚㄽ	욄
ㅇㅚㄾ	욅
ㅇㅚㄿ	욆
ㅇㅚㅀ	욇
ㅇㅚㅁ	욈
ㅇㅚㅂ	욉
ㅇㅚㅄ	욊
ㅇㅚㅅ	욋
ㅇㅚㅆ	욌
ㅇㅚㅇ	욍
ㅇㅚㅈ	욎
ㅇㅚㅊ	욏
ㅇㅚㅋ	욐
ㅇㅚㅌ	욑
ㅇㅚㅍ	욒
ㅇㅚㅎ	욓
ㅇㅛ	요
ㅇㅛㄱ	욕
ㅇㅛㄲ	욖
ㅇㅛㄳ	욗
ㅇㅛㄴ	욘
ㅇㅛㄵ	욙
ㅇㅛㄶ	욚
ㅇㅛㄷ	욛
ㅇㅛㄹ	욜
ㅇㅛㄺ	욝
ㅇㅛㄻ	욞
ㅇㅛㄼ	욟
ㅇㅛㄽ	욠
ㅇㅛㄾ	욡
ㅇㅛㄿ	욢
ㅇㅛㅀ	욣
ㅇㅛㅁ	욤
ㅇㅛㅂ	욥
ㅇㅛㅄ	욦
ㅇㅛㅅ	욧
ㅇㅛㅆ	욨
ㅇㅛㅇ	용
ㅇㅛㅈ	욪
ㅇㅛㅊ	욫
ㅇㅛㅋ	욬
ㅇㅛㅌ	욭
ㅇㅛㅍ	욮
ㅇㅛㅎ	욯
ㅇㅜ	우
ㅇㅜㄱ	욱
ㅇㅜㄲ	욲
ㅇㅜㄳ	욳
ㅇㅜㄴ	운
ㅇㅜㄵ	욵
ㅇㅜㄶ	욶
ㅇㅜㄷ	욷
ㅇㅜㄹ	울
ㅇㅜㄺ	욹
ㅇㅜㄻ	욺
ㅇㅜㄼ	욻
ㅇㅜㄽ	욼
ㅇㅜㄾ	욽
ㅇㅜㄿ	욾
ㅇㅜㅀ	욿
ㅇㅜㅁ	움
ㅇㅜㅂ	웁
ㅇㅜㅄ	웂
ㅇㅜㅅ	웃
ㅇㅜㅆ	웄
ㅇㅜㅇ	웅
ㅇㅜㅈ	웆
ㅇㅜㅊ	웇
ㅇㅜㅋ	웈
ㅇㅜㅌ	웉
ㅇㅜㅍ	웊
ㅇㅜㅎ	웋
ㅇㅝ	워
ㅇㅝㄱ	웍
ㅇㅝㄲ	웎
ㅇㅝㄳ	웏
ㅇㅝㄴ	원
ㅇㅝㄵ	웑
ㅇㅝㄶ	웒
ㅇㅝㄷ	웓
ㅇㅝㄹ	월
ㅇㅝㄺ	웕
ㅇㅝㄻ	웖
ㅇㅝㄼ	웗
ㅇㅝㄽ	웘
ㅇㅝㄾ	웙
ㅇㅝㄿ	웚
ㅇㅝㅀ	웛
ㅇㅝㅁ	웜
ㅇㅝㅂ	웝
ㅇㅝㅄ	웞
ㅇㅝㅅ	웟
ㅇㅝㅆ	웠
ㅇㅝㅇ	웡
ㅇㅝㅈ	웢
ㅇㅝㅊ	웣
ㅇㅝㅋ	웤
ㅇㅝㅌ	웥
ㅇㅝㅍ	웦
ㅇㅝㅎ	웧
ㅇㅞ	웨
ㅇㅞㄱ	웩
ㅇㅞㄲ	웪
ㅇㅞㄳ	웫
ㅇㅞㄴ	웬
ㅇㅞㄵ	웭
ㅇㅞㄶ	웮
ㅇㅞㄷ	웯
ㅇㅞㄹ	웰
ㅇㅞㄺ	웱
ㅇㅞㄻ	웲
ㅇㅞㄼ	웳
ㅇㅞㄽ	웴
ㅇㅞㄾ	웵
ㅇㅞㄿ	웶
ㅇㅞㅀ	웷
ㅇㅞㅁ	웸
ㅇㅞㅂ	웹
ㅇㅞㅄ	웺
ㅇㅞㅅ	웻
ㅇㅞㅆ	웼
ㅇㅞㅇ	웽
ㅇㅞㅈ	웾
ㅇㅞㅊ	웿
ㅇㅞㅋ	윀
ㅇㅞㅌ	윁
ㅇㅞㅍ	윂
ㅇㅞㅎ	윃
ㅇㅟ	위
ㅇㅟㄱ	윅
ㅇㅟㄲ	윆
ㅇㅟㄳ	윇
ㅇㅟㄴ	윈
ㅇㅟㄵ	윉
ㅇㅟㄶ	윊
ㅇㅟㄷ	윋
ㅇㅟㄹ	윌
ㅇㅟㄺ	윍
ㅇㅟㄻ	윎
ㅇㅟㄼ	윏
ㅇㅟㄽ	윐
ㅇㅟㄾ	윑
ㅇㅟㄿ	윒
ㅇㅟㅀ	윓
ㅇㅟㅁ	윔
ㅇㅟㅂ	윕
ㅇㅟㅄ	윖
ㅇㅟㅅ	윗
ㅇㅟㅆ	윘
ㅇㅟㅇ	윙
ㅇㅟㅈ	윚
ㅇㅟㅊ	윛
ㅇㅟㅋ	윜
ㅇㅟㅌ	윝
ㅇㅟㅍ	윞
ㅇㅟㅎ	윟
ㅇㅠ	유
ㅇㅠㄱ	육
ㅇㅠㄲ	윢
ㅇㅠㄳ	윣
ㅇㅠㄴ	윤
ㅇㅠㄵ	윥
ㅇㅠㄶ	윦
ㅇㅠㄷ	윧
ㅇㅠㄹ	율
ㅇㅠㄺ	윩
ㅇㅠㄻ	윪
ㅇㅠㄼ	윫
ㅇㅠㄽ	윬
ㅇㅠㄾ	윭
ㅇㅠㄿ	윮
ㅇㅠㅀ	윯
ㅇㅠㅁ	윰
ㅇㅠㅂ	윱
ㅇㅠㅄ	윲
ㅇㅠㅅ	윳
ㅇㅠㅆ	윴
ㅇㅠㅇ	융
ㅇㅠㅈ	윶
ㅇㅠㅊ	윷
ㅇㅠㅋ	윸
ㅇㅠㅌ	윹
ㅇㅠㅍ	윺
ㅇㅠㅎ	윻
ㅇㅡ	으
ㅇㅡㄱ	윽
ㅇㅡㄲ	윾
ㅇㅡㄳ	윿
ㅇㅡㄴ	은
ㅇㅡㄵ	읁
ㅇㅡㄶ	읂
ㅇㅡㄷ	읃
ㅇㅡㄹ	을
ㅇㅡㄺ	읅
ㅇㅡㄻ	읆
ㅇㅡㄼ	읇
ㅇㅡㄽ	읈
ㅇㅡㄾ	읉
ㅇㅡㄿ	읊
ㅇㅡㅀ	읋
ㅇㅡㅁ	음
ㅇㅡㅂ	읍
ㅇㅡㅄ	읎
ㅇㅡㅅ	읏
ㅇㅡㅆ	읐
ㅇㅡㅇ	응
ㅇㅡㅈ	읒
ㅇㅡㅊ	읓
ㅇㅡㅋ	읔
ㅇㅡㅌ	읕
ㅇㅡㅍ	읖
ㅇㅡㅎ	읗
ㅇㅢ	의
ㅇㅢㄱ	읙
ㅇㅢㄲ	읚
ㅇㅢㄳ	읛
ㅇㅢㄴ	읜
ㅇㅢㄵ	읝
ㅇㅢㄶ	읞
ㅇㅢㄷ	읟
ㅇㅢㄹ	읠
ㅇㅢㄺ	읡
ㅇㅢㄻ	읢
ㅇㅢㄼ	읣
ㅇㅢㄽ	읤
ㅇㅢㄾ	읥
ㅇㅢㄿ	읦
ㅇㅢㅀ	읧
ㅇㅢㅁ	읨
ㅇㅢㅂ	읩
ㅇㅢㅄ	읪
ㅇㅢㅅ	읫
ㅇㅢㅆ	읬
ㅇㅢㅇ	읭
ㅇㅢㅈ	읮
ㅇㅢㅊ	읯
ㅇㅢㅋ	읰
ㅇㅢㅌ	읱
ㅇㅢㅍ	읲
ㅇㅢㅎ	읳
ㅇㅣ	이
ㅇㅣㄱ	익
ㅇㅣㄲ	읶
ㅇㅣㄳ	읷
ㅇㅣㄴ	인
ㅇㅣㄵ	읹
ㅇㅣㄶ	읺
ㅇㅣㄷ	읻
ㅇㅣㄹ	일
ㅇㅣㄺ	읽
ㅇㅣㄻ	읾
ㅇㅣㄼ	읿
ㅇㅣㄽ	잀
ㅇㅣㄾ	잁
ㅇㅣㄿ	잂
ㅇㅣㅀ	잃
ㅇㅣㅁ	임
ㅇㅣㅂ	입
ㅇㅣㅄ	잆
ㅇㅣㅅ	잇
ㅇㅣㅆ	있
ㅇㅣㅇ	잉
ㅇㅣㅈ	잊
ㅇㅣㅊ	잋
ㅇㅣㅋ	잌
ㅇㅣㅌ	잍
ㅇㅣㅍ	잎
ㅇㅣㅎ	잏
ㅈㅏ	자
ㅈㅏㄱ	작
ㅈㅏㄲ	잒
ㅈㅏㄳ	잓
ㅈㅏㄴ	잔
ㅈㅏㄵ	잕
ㅈㅏㄶ	잖
ㅈㅏㄷ	잗
ㅈㅏㄹ	잘
ㅈㅏㄺ	잙
ㅈㅏㄻ	잚
ㅈㅏㄼ	잛
ㅈㅏㄽ	잜
ㅈㅏㄾ	잝
ㅈㅏㄿ	잞
ㅈㅏㅀ	잟
ㅈㅏㅁ	잠
ㅈㅏㅂ	잡
ㅈㅏㅄ	잢
ㅈㅏㅅ	잣
ㅈㅏㅆ	잤
ㅈㅏㅇ	장
ㅈㅏㅈ	잦
ㅈㅏㅊ	잧
ㅈㅏㅋ	잨
ㅈㅏㅌ	잩
ㅈㅏㅍ	잪
ㅈㅏㅎ	잫
ㅈㅐ	재
ㅈㅐㄱ	잭
ㅈㅐㄲ	잮
ㅈㅐㄳ	잯
ㅈㅐㄴ	잰
ㅈㅐㄵ	잱
ㅈㅐㄶ	잲
ㅈㅐㄷ	잳
ㅈㅐㄹ	잴
ㅈㅐㄺ	잵
ㅈㅐㄻ	잶
ㅈㅐㄼ	잷
ㅈㅐㄽ	잸
ㅈㅐㄾ	잹
ㅈㅐㄿ	잺
ㅈㅐㅀ	잻
ㅈㅐㅁ	잼
ㅈㅐㅂ	잽
ㅈㅐㅄ	잾
ㅈㅐㅅ	잿
ㅈㅐㅆ	쟀
ㅈㅐㅇ	쟁
ㅈㅐㅈ	쟂
ㅈㅐㅊ	쟃
ㅈㅐㅋ	쟄
ㅈㅐㅌ	쟅
ㅈㅐㅍ	쟆
ㅈㅐㅎ	쟇
ㅈㅑ	쟈
ㅈㅑㄱ	쟉
ㅈㅑㄲ	쟊
ㅈㅑㄳ	쟋
ㅈㅑㄴ	쟌
ㅈㅑㄵ	쟍
ㅈㅑㄶ	쟎
ㅈㅑㄷ	쟏
ㅈㅑㄹ	쟐
ㅈㅑㄺ	쟑
ㅈㅑㄻ	쟒
ㅈㅑㄼ	쟓
ㅈㅑㄽ	쟔
ㅈㅑㄾ	쟕
ㅈㅑㄿ	쟖
ㅈㅑㅀ	쟗
ㅈㅑㅁ	쟘
ㅈㅑㅂ	쟙
ㅈㅑㅄ	쟚
ㅈㅑㅅ	쟛
ㅈㅑㅆ	쟜
ㅈㅑㅇ	쟝
ㅈㅑㅈ	쟞
ㅈㅑㅊ	쟟
ㅈㅑㅋ	쟠
ㅈㅑㅌ	쟡
ㅈㅑㅍ	쟢
ㅈㅑㅎ	쟣
ㅈㅒ	쟤
ㅈㅒㄱ	쟥
ㅈㅒㄲ	쟦
ㅈㅒㄳ	쟧
ㅈㅒㄴ	쟨
ㅈㅒㄵ	쟩
ㅈㅒㄶ	쟪
ㅈㅒㄷ	쟫
ㅈㅒㄹ	쟬
ㅈㅒㄺ	쟭
ㅈㅒㄻ	쟮
ㅈㅒㄼ	쟯
ㅈㅒㄽ	쟰
ㅈㅒㄾ	쟱
ㅈㅒㄿ	쟲
ㅈㅒㅀ	쟳
ㅈㅒㅁ	쟴
ㅈㅒㅂ	쟵
ㅈㅒㅄ	쟶
ㅈㅒㅅ	쟷
ㅈㅒㅆ	쟸
ㅈㅒㅇ	쟹
ㅈㅒㅈ	쟺
ㅈㅒㅊ	쟻
ㅈㅒㅋ	쟼
ㅈㅒㅌ	쟽
ㅈㅒㅍ	쟾
ㅈㅒㅎ	쟿
ㅈㅓ	저
ㅈㅓㄱ	적
ㅈㅓㄲ	젂
ㅈㅓㄳ	젃
ㅈㅓㄴ	전
ㅈㅓㄵ	젅
ㅈㅓㄶ	젆
ㅈㅓㄷ	젇
ㅈㅓㄹ	절
ㅈㅓㄺ	젉
ㅈㅓㄻ	젊
ㅈㅓㄼ	젋
ㅈㅓㄽ	젌
ㅈㅓㄾ	젍
ㅈㅓㄿ	젎
ㅈㅓㅀ	젏
ㅈㅓㅁ	점
ㅈㅓㅂ	접
ㅈㅓㅄ	젒
ㅈㅓㅅ	젓
ㅈㅓㅆ	젔
ㅈㅓㅇ	정
ㅈㅓㅈ	젖
ㅈㅓㅊ	젗
ㅈㅓㅋ	젘
ㅈㅓㅌ	젙
ㅈㅓㅍ	젚
ㅈㅓㅎ	젛
ㅈㅔ	제
ㅈㅔㄱ	젝
ㅈㅔㄲ	젞
ㅈㅔㄳ	젟
ㅈㅔㄴ	젠
ㅈㅔㄵ	젡
ㅈㅔㄶ	젢
ㅈㅔㄷ	젣
ㅈㅔㄹ	젤
ㅈㅔㄺ	젥
ㅈㅔㄻ	젦
ㅈㅔㄼ	젧
ㅈㅔㄽ	젨
ㅈㅔㄾ	젩
ㅈㅔㄿ	젪
ㅈㅔㅀ	젫
ㅈㅔㅁ	젬
ㅈㅔㅂ	젭
ㅈㅔㅄ	젮
ㅈㅔㅅ	젯
ㅈㅔㅆ	젰
ㅈㅔㅇ	젱
ㅈㅔㅈ	젲
ㅈㅔㅊ	젳
ㅈㅔㅋ	젴
ㅈㅔㅌ	젵
ㅈㅔㅍ	젶
ㅈㅔㅎ	젷
ㅈㅕ	져
ㅈㅕㄱ	젹
ㅈㅕㄲ	젺
ㅈㅕㄳ	젻
ㅈㅕㄴ	젼
ㅈㅕㄵ	젽
ㅈㅕㄶ	젾
ㅈㅕㄷ	젿
ㅈㅕㄹ	졀
ㅈㅕㄺ	졁
ㅈㅕㄻ	졂
ㅈㅕㄼ	졃
ㅈㅕㄽ	졄
ㅈㅕㄾ	졅
ㅈㅕㄿ	졆
ㅈㅕㅀ	졇
ㅈㅕㅁ	졈
ㅈㅕㅂ	졉
ㅈㅕㅄ	졊
ㅈㅕㅅ	졋
ㅈㅕㅆ	졌
ㅈㅕㅇ	졍
ㅈㅕㅈ	졎
ㅈㅕㅊ	졏
ㅈㅕㅋ	졐
ㅈㅕㅌ	졑
ㅈㅕㅍ	졒
ㅈㅕㅎ	졓
ㅈㅖ	졔
ㅈㅖㄱ	졕
ㅈㅖㄲ	졖
ㅈㅖㄳ	졗
ㅈㅖㄴ	졘
ㅈㅖㄵ	졙
ㅈㅖㄶ	졚
ㅈㅖㄷ	졛
ㅈㅖㄹ	졜
ㅈㅖㄺ	졝
ㅈㅖㄻ	졞
ㅈㅖㄼ	졟
ㅈㅖㄽ	졠
ㅈㅖㄾ	졡
ㅈㅖㄿ	졢
ㅈㅖㅀ	졣
ㅈㅖㅁ	졤
ㅈㅖㅂ	졥
ㅈㅖㅄ	졦
ㅈㅖㅅ	졧
ㅈㅖㅆ	졨
ㅈㅖㅇ	졩
ㅈㅖㅈ	졪
ㅈㅖㅊ	졫
ㅈㅖㅋ	졬
ㅈㅖㅌ	졭
ㅈㅖㅍ	졮
ㅈㅖㅎ	졯
ㅈㅗ	조
ㅈㅗㄱ	족
ㅈㅗㄲ	졲
ㅈㅗㄳ	졳
ㅈㅗㄴ	존
ㅈㅗㄵ	졵
ㅈㅗㄶ	졶
ㅈㅗㄷ	졷
ㅈㅗㄹ	졸
ㅈㅗㄺ	졹
ㅈㅗㄻ	졺
ㅈㅗㄼ	졻
ㅈㅗㄽ	졼
ㅈㅗㄾ	졽
ㅈㅗㄿ	졾
ㅈㅗㅀ	졿
ㅈㅗㅁ	좀
ㅈㅗㅂ	좁
ㅈㅗㅄ	좂
ㅈㅗㅅ	좃
ㅈㅗㅆ	좄
ㅈㅗㅇ	종
ㅈㅗㅈ	좆
ㅈㅗㅊ	좇
ㅈㅗㅋ	좈
ㅈㅗㅌ	좉
ㅈㅗㅍ	좊
ㅈㅗㅎ	좋
ㅈㅘ	좌
ㅈㅘㄱ	좍
ㅈㅘㄲ	좎
ㅈㅘㄳ	좏
ㅈㅘㄴ	좐
ㅈㅘㄵ	좑
ㅈㅘㄶ	좒
ㅈㅘㄷ	좓
ㅈㅘㄹ	좔
ㅈㅘㄺ	좕
ㅈㅘㄻ	좖
ㅈㅘㄼ	좗
ㅈㅘㄽ	좘
ㅈㅘㄾ	좙
ㅈㅘㄿ	좚
ㅈㅘㅀ	좛
ㅈㅘㅁ	좜
ㅈㅘㅂ	좝
ㅈㅘㅄ	좞
ㅈㅘㅅ	좟
ㅈㅘㅆ	좠
ㅈㅘㅇ	좡
ㅈㅘㅈ	좢
ㅈㅘㅊ	좣
ㅈㅘㅋ	좤
ㅈㅘㅌ	좥
ㅈㅘㅍ	좦
ㅈㅘㅎ	좧
ㅈㅙ	좨
ㅈㅙㄱ	좩
ㅈㅙㄲ	좪
ㅈㅙㄳ	좫
ㅈㅙㄴ	좬
ㅈㅙㄵ	좭
ㅈㅙㄶ	좮
ㅈㅙㄷ	좯
ㅈㅙㄹ	좰
ㅈㅙㄺ	좱
ㅈㅙㄻ	좲
ㅈㅙㄼ	좳
ㅈㅙㄽ	좴
ㅈㅙㄾ	좵
ㅈㅙㄿ	좶
ㅈㅙㅀ	좷
ㅈㅙㅁ	좸
ㅈㅙㅂ	좹
ㅈㅙㅄ	좺
ㅈㅙㅅ	좻
ㅈㅙㅆ	좼
ㅈㅙㅇ	좽
ㅈㅙㅈ	좾
ㅈㅙㅊ	좿
ㅈㅙㅋ	죀
ㅈㅙㅌ	죁
ㅈㅙㅍ	죂
ㅈㅙㅎ	죃
ㅈㅚ	죄
ㅈㅚㄱ	죅
ㅈㅚㄲ	죆
ㅈㅚㄳ	죇
ㅈㅚㄴ	죈
ㅈㅚㄵ	죉
ㅈㅚㄶ	죊
ㅈㅚㄷ	죋
ㅈㅚㄹ	죌
ㅈㅚㄺ	죍
ㅈㅚㄻ	죎
ㅈㅚㄼ	죏
ㅈㅚㄽ	죐
ㅈㅚㄾ	죑
ㅈㅚㄿ	죒
ㅈㅚㅀ	죓
ㅈㅚㅁ	죔
ㅈㅚㅂ	죕
ㅈㅚㅄ	죖
ㅈㅚㅅ	죗
ㅈㅚㅆ	죘
ㅈㅚㅇ	죙
ㅈㅚㅈ	죚
ㅈㅚㅊ	죛
ㅈㅚㅋ	죜
ㅈㅚㅌ	죝
ㅈㅚㅍ	죞
ㅈㅚㅎ	죟
ㅈㅛ	죠
ㅈㅛㄱ	죡
ㅈㅛㄲ	죢
ㅈㅛㄳ	죣
ㅈㅛㄴ	죤
ㅈㅛㄵ	죥
ㅈㅛㄶ	죦
ㅈㅛㄷ	죧
ㅈㅛㄹ	죨
ㅈㅛㄺ	죩
ㅈㅛㄻ	죪
ㅈㅛㄼ	죫
ㅈㅛㄽ	죬
ㅈㅛㄾ	죭
ㅈㅛㄿ	죮
ㅈㅛㅀ	죯
ㅈㅛㅁ	죰
ㅈㅛㅂ	죱
ㅈㅛㅄ	죲
ㅈㅛㅅ	죳
ㅈㅛㅆ	죴
ㅈㅛㅇ	죵
ㅈㅛㅈ	죶
ㅈㅛㅊ	죷
ㅈㅛㅋ	죸
ㅈㅛㅌ	죹
ㅈㅛㅍ	죺
ㅈㅛㅎ	죻
ㅈㅜ	주
ㅈㅜㄱ	죽
ㅈㅜㄲ	죾
ㅈㅜㄳ	죿
ㅈㅜㄴ	준
ㅈㅜㄵ	줁
ㅈㅜㄶ	줂
ㅈㅜㄷ	줃
ㅈㅜㄹ	줄
ㅈㅜㄺ	줅
ㅈㅜㄻ	줆
ㅈㅜㄼ	줇
ㅈㅜㄽ	줈
ㅈㅜㄾ	줉
ㅈㅜㄿ	줊
ㅈㅜㅀ	줋
ㅈㅜㅁ	줌
ㅈㅜㅂ	줍
ㅈㅜㅄ	줎
ㅈㅜㅅ	줏
ㅈㅜㅆ	줐
ㅈㅜㅇ	중
ㅈㅜㅈ	줒
ㅈㅜㅊ	줓
ㅈㅜㅋ	줔
ㅈㅜㅌ	줕
ㅈㅜㅍ	줖
ㅈㅜㅎ	줗
ㅈㅝ	줘
ㅈㅝㄱ	줙
ㅈㅝㄲ	줚
ㅈㅝㄳ	줛
ㅈㅝㄴ	줜
ㅈㅝㄵ	줝
ㅈㅝㄶ	줞
ㅈㅝㄷ	줟
ㅈㅝㄹ	줠
ㅈㅝㄺ	줡
ㅈㅝㄻ	줢
ㅈㅝㄼ	줣
ㅈㅝㄽ	줤
ㅈㅝㄾ	줥
ㅈㅝㄿ	줦
ㅈㅝㅀ	줧
ㅈㅝㅁ	줨
ㅈㅝㅂ	줩
ㅈㅝㅄ	줪
ㅈㅝㅅ	줫
ㅈㅝㅆ	줬
ㅈㅝㅇ	줭
ㅈㅝㅈ	줮
ㅈㅝㅊ	줯
ㅈㅝㅋ	줰
ㅈㅝㅌ	줱
ㅈㅝㅍ	줲
ㅈㅝㅎ	줳
ㅈㅞ	줴
ㅈㅞㄱ	줵
ㅈㅞㄲ	줶
ㅈㅞㄳ	줷
ㅈㅞㄴ	줸
ㅈㅞㄵ	줹
ㅈㅞㄶ	줺
ㅈㅞㄷ	줻
ㅈㅞㄹ	줼
ㅈㅞㄺ	줽
ㅈㅞㄻ	줾
ㅈㅞㄼ	줿
ㅈㅞㄽ	쥀
ㅈㅞㄾ	쥁
ㅈㅞㄿ	쥂
ㅈㅞㅀ	쥃
ㅈㅞㅁ	쥄
ㅈㅞㅂ	쥅
ㅈㅞㅄ	쥆
ㅈㅞㅅ	쥇
ㅈㅞㅆ	쥈
ㅈㅞㅇ	쥉
ㅈㅞㅈ	쥊
ㅈㅞㅊ	쥋
ㅈㅞㅋ	쥌
ㅈㅞㅌ	쥍
ㅈㅞㅍ	쥎
ㅈㅞㅎ	쥏
ㅈㅟ	쥐
ㅈㅟㄱ	쥑
ㅈㅟㄲ	쥒
ㅈㅟㄳ	쥓
ㅈㅟㄴ	쥔
ㅈㅟㄵ	쥕
ㅈㅟㄶ	쥖
ㅈㅟㄷ	쥗
ㅈㅟㄹ	쥘
ㅈㅟㄺ	쥙
ㅈㅟㄻ	쥚
ㅈㅟㄼ	쥛
ㅈㅟㄽ	쥜
ㅈㅟㄾ	쥝
ㅈㅟㄿ	쥞
ㅈㅟㅀ	쥟
ㅈㅟㅁ	쥠
ㅈㅟㅂ	쥡
ㅈㅟㅄ	쥢
ㅈㅟㅅ	쥣
ㅈㅟㅆ	쥤
ㅈㅟㅇ	쥥
ㅈㅟㅈ	쥦
ㅈㅟㅊ	쥧
ㅈㅟㅋ	쥨
ㅈㅟㅌ	쥩
ㅈㅟㅍ	쥪
ㅈㅟㅎ	쥫
ㅈㅠ	쥬
ㅈㅠㄱ	쥭
ㅈㅠㄲ	쥮
ㅈㅠㄳ	쥯
ㅈㅠㄴ	쥰
ㅈㅠㄵ	쥱
ㅈㅠㄶ	쥲
ㅈㅠㄷ	쥳
ㅈㅠㄹ	쥴
ㅈㅠㄺ	쥵
ㅈㅠㄻ	쥶
ㅈㅠㄼ	쥷
ㅈㅠㄽ	쥸
ㅈㅠㄾ	쥹
ㅈㅠㄿ	쥺
ㅈㅠㅀ	쥻
ㅈㅠㅁ	쥼
ㅈㅠㅂ	쥽
ㅈㅠㅄ	쥾
ㅈㅠㅅ	쥿
ㅈㅠㅆ	즀
ㅈㅠㅇ	즁
ㅈㅠㅈ	즂
ㅈㅠㅊ	즃
ㅈㅠㅋ	즄
ㅈㅠㅌ	즅
ㅈㅠㅍ	즆
ㅈㅠㅎ	즇
ㅈㅡ	즈
ㅈㅡㄱ	즉
ㅈㅡㄲ	즊
ㅈㅡㄳ	즋
ㅈㅡㄴ	즌
ㅈㅡㄵ	즍
ㅈㅡㄶ	즎
ㅈㅡㄷ	즏
ㅈㅡㄹ	즐
ㅈㅡㄺ	즑
ㅈㅡㄻ	즒
ㅈㅡㄼ	즓
ㅈㅡㄽ	즔
ㅈㅡㄾ	즕
ㅈㅡㄿ	즖
ㅈㅡㅀ	즗
ㅈㅡㅁ	즘
ㅈㅡㅂ	즙
ㅈㅡㅄ	즚
ㅈㅡㅅ	즛
ㅈㅡㅆ	즜
ㅈㅡㅇ	증
ㅈㅡㅈ	즞
ㅈㅡㅊ	즟
ㅈㅡㅋ	즠
ㅈㅡㅌ	즡
ㅈㅡㅍ	즢
ㅈㅡㅎ	즣
ㅈㅢ	즤
ㅈㅢㄱ	즥
ㅈㅢㄲ	즦
ㅈㅢㄳ	즧
ㅈㅢㄴ	즨
ㅈㅢㄵ	즩
ㅈㅢㄶ	즪
ㅈㅢㄷ	즫
ㅈㅢㄹ	즬
ㅈㅢㄺ	즭
ㅈㅢㄻ	즮
ㅈㅢㄼ	즯
ㅈㅢㄽ	즰
ㅈㅢㄾ	즱
ㅈㅢㄿ	즲
ㅈㅢㅀ	즳
ㅈㅢㅁ	즴
ㅈㅢㅂ	즵
ㅈㅢㅄ	즶
ㅈㅢㅅ	즷
ㅈㅢㅆ	즸
ㅈㅢㅇ	즹
ㅈㅢㅈ	즺
ㅈㅢㅊ	즻
ㅈㅢㅋ	즼
ㅈㅢㅌ	즽
ㅈㅢㅍ	즾
ㅈㅢㅎ	즿
ㅈㅣ	지
ㅈㅣㄱ	직
ㅈㅣㄲ	짂
ㅈㅣㄳ	짃
ㅈㅣㄴ	진
ㅈㅣㄵ	짅
ㅈㅣㄶ	짆
ㅈㅣㄷ	짇
ㅈㅣㄹ	질
ㅈㅣㄺ	짉
ㅈㅣㄻ	짊
ㅈㅣㄼ	짋
ㅈㅣㄽ	짌
ㅈㅣㄾ	짍
ㅈㅣㄿ	짎
ㅈㅣㅀ	짏
ㅈㅣㅁ	짐
ㅈㅣㅂ	집
ㅈㅣㅄ	짒
ㅈㅣㅅ	짓
ㅈㅣㅆ	짔
ㅈㅣㅇ	징
ㅈㅣㅈ	짖
ㅈㅣㅊ	짗
ㅈㅣㅋ	짘
ㅈㅣㅌ	짙
ㅈㅣㅍ	짚
ㅈㅣㅎ	짛
ㅉㅏ	짜
ㅉㅏㄱ	짝
ㅉㅏㄲ	짞
ㅉㅏㄳ	짟
ㅉㅏㄴ	짠
ㅉㅏㄵ	짡
ㅉㅏㄶ	짢
ㅉㅏㄷ	짣
ㅉㅏㄹ	짤
ㅉㅏㄺ	짥
ㅉㅏㄻ	짦
ㅉㅏㄼ	짧
ㅉㅏㄽ	짨
ㅉㅏㄾ	짩
ㅉㅏㄿ	짪
ㅉㅏㅀ	짫
ㅉㅏㅁ	짬
ㅉㅏㅂ	짭
ㅉㅏㅄ	짮
ㅉㅏㅅ	짯
ㅉㅏㅆ	짰
ㅉㅏㅇ	짱
ㅉㅏㅈ	짲
ㅉㅏㅊ	짳
ㅉㅏㅋ	짴
ㅉㅏㅌ	짵
ㅉㅏㅍ	짶
ㅉㅏㅎ	짷
ㅉㅐ	째
ㅉㅐㄱ	짹
ㅉㅐㄲ	짺
ㅉㅐㄳ	짻
ㅉㅐㄴ	짼
ㅉㅐㄵ	짽
ㅉㅐㄶ	짾
ㅉㅐㄷ	짿
ㅉㅐㄹ	쨀
ㅉㅐㄺ	쨁
ㅉㅐㄻ	쨂
ㅉㅐㄼ	쨃
ㅉㅐㄽ	쨄
ㅉㅐㄾ	쨅
ㅉㅐㄿ	쨆
ㅉㅐㅀ	쨇
ㅉㅐㅁ	쨈
ㅉㅐㅂ	쨉
ㅉㅐㅄ	쨊
ㅉㅐㅅ	쨋
ㅉㅐㅆ	쨌
ㅉㅐㅇ	쨍
ㅉㅐㅈ	쨎
ㅉㅐㅊ	쨏
ㅉㅐㅋ	쨐
ㅉㅐㅌ	쨑
ㅉㅐㅍ	쨒
ㅉㅐㅎ	쨓
ㅉㅑ	쨔
ㅉㅑㄱ	쨕
ㅉㅑㄲ	쨖
ㅉㅑㄳ	쨗
ㅉㅑㄴ	쨘
ㅉㅑㄵ	쨙
ㅉㅑㄶ	쨚
ㅉㅑㄷ	쨛
ㅉㅑㄹ	쨜
ㅉㅑㄺ	쨝
ㅉㅑㄻ	쨞
ㅉㅑㄼ	쨟
ㅉㅑㄽ	쨠
ㅉㅑㄾ	쨡
ㅉㅑㄿ	쨢
ㅉㅑㅀ	쨣
ㅉㅑㅁ	쨤
ㅉㅑㅂ	쨥
ㅉㅑㅄ	쨦
ㅉㅑㅅ	쨧
ㅉㅑㅆ	쨨
ㅉㅑㅇ	쨩
ㅉㅑㅈ	쨪
ㅉㅑㅊ	쨫
ㅉㅑㅋ	쨬
ㅉㅑㅌ	쨭
ㅉㅑㅍ	쨮
ㅉㅑㅎ	쨯
ㅉㅒ	쨰
ㅉㅒㄱ	쨱
ㅉㅒㄲ	쨲
ㅉㅒㄳ	쨳
ㅉㅒㄴ	쨴
ㅉㅒㄵ	쨵
ㅉㅒㄶ	쨶
ㅉㅒㄷ	쨷
ㅉㅒㄹ	쨸
ㅉㅒㄺ	쨹
ㅉㅒㄻ	쨺
ㅉㅒㄼ	쨻
ㅉㅒㄽ	쨼
ㅉㅒㄾ	쨽
ㅉㅒㄿ	쨾
ㅉㅒㅀ	쨿
ㅉㅒㅁ	쩀
ㅉㅒㅂ	쩁
ㅉㅒㅄ	쩂
ㅉㅒㅅ	쩃
ㅉㅒㅆ	쩄
ㅉㅒㅇ	쩅
ㅉㅒㅈ	쩆
ㅉㅒㅊ	쩇
ㅉㅒㅋ	쩈
ㅉㅒㅌ	쩉
ㅉㅒㅍ	쩊
ㅉㅒㅎ	쩋
ㅉㅓ	쩌
ㅉㅓㄱ	쩍
ㅉㅓㄲ	쩎
ㅉㅓㄳ	쩏
ㅉㅓㄴ	쩐
ㅉㅓㄵ	쩑
ㅉㅓㄶ	쩒
ㅉㅓㄷ	쩓
ㅉㅓㄹ	쩔
ㅉㅓㄺ	쩕
ㅉㅓㄻ	쩖
ㅉㅓㄼ	쩗
ㅉㅓㄽ	쩘
ㅉㅓㄾ	쩙
ㅉㅓㄿ	쩚
ㅉㅓㅀ	쩛
ㅉㅓㅁ	쩜
ㅉㅓㅂ	쩝
ㅉㅓㅄ	쩞
ㅉㅓㅅ	쩟
ㅉㅓㅆ	쩠
ㅉㅓㅇ	쩡
ㅉㅓㅈ	쩢
ㅉㅓㅊ	쩣
ㅉㅓㅋ	쩤
ㅉㅓㅌ	쩥
ㅉㅓㅍ	쩦
ㅉㅓㅎ	쩧
ㅉㅔ	쩨
ㅉㅔㄱ	쩩
ㅉㅔㄲ	쩪
ㅉㅔㄳ	쩫
ㅉㅔㄴ	쩬
ㅉㅔㄵ	쩭
ㅉㅔㄶ	쩮
ㅉㅔㄷ	쩯
ㅉㅔㄹ	쩰
ㅉㅔㄺ	쩱
ㅉㅔㄻ	쩲
ㅉㅔㄼ	쩳
ㅉㅔㄽ	쩴
ㅉㅔㄾ	쩵
ㅉㅔㄿ	쩶
ㅉㅔㅀ	쩷
ㅉㅔㅁ	쩸
ㅉㅔㅂ	쩹
ㅉㅔㅄ	쩺
ㅉㅔㅅ	쩻
ㅉㅔㅆ	쩼
ㅉㅔㅇ	쩽
ㅉㅔㅈ	쩾
ㅉㅔㅊ	쩿
ㅉㅔㅋ	쪀
ㅉㅔㅌ	쪁
ㅉㅔㅍ	쪂
ㅉㅔㅎ	쪃
ㅉㅕ	쪄
ㅉㅕㄱ	쪅
ㅉㅕㄲ	쪆
ㅉㅕㄳ	쪇
ㅉㅕㄴ	쪈
ㅉㅕㄵ	쪉
ㅉㅕㄶ	쪊
ㅉㅕㄷ	쪋
ㅉㅕㄹ	쪌
ㅉㅕㄺ	쪍
ㅉㅕㄻ	쪎
ㅉㅕㄼ	쪏
ㅉㅕㄽ	쪐
ㅉㅕㄾ	쪑
ㅉㅕㄿ	쪒
ㅉㅕㅀ	쪓
ㅉㅕㅁ	쪔
ㅉㅕㅂ	쪕
ㅉㅕㅄ	쪖
ㅉㅕㅅ	쪗
ㅉㅕㅆ	쪘
ㅉㅕㅇ	쪙
ㅉㅕㅈ	쪚
ㅉㅕㅊ	쪛
ㅉㅕㅋ	쪜
ㅉㅕㅌ	쪝
ㅉㅕㅍ	쪞
ㅉㅕㅎ	쪟
ㅉㅖ	쪠
ㅉㅖㄱ	쪡
ㅉㅖㄲ	쪢
ㅉㅖㄳ	쪣
ㅉㅖㄴ	쪤
ㅉㅖㄵ	쪥
ㅉㅖㄶ	쪦
ㅉㅖㄷ	쪧
ㅉㅖㄹ	쪨
ㅉㅖㄺ	쪩
ㅉㅖㄻ	쪪
ㅉㅖㄼ	쪫
ㅉㅖㄽ	쪬
ㅉㅖㄾ	쪭
ㅉㅖㄿ	쪮
ㅉㅖㅀ	쪯
ㅉㅖㅁ	쪰
ㅉㅖㅂ	쪱
ㅉㅖㅄ	쪲
ㅉㅖㅅ	쪳
ㅉㅖㅆ	쪴
ㅉㅖㅇ	쪵
ㅉㅖㅈ	쪶
ㅉㅖㅊ	쪷
ㅉㅖㅋ	쪸
ㅉㅖㅌ	쪹
ㅉㅖㅍ	쪺
ㅉㅖㅎ	쪻
ㅉㅗ	쪼
ㅉㅗㄱ	쪽
ㅉㅗㄲ	쪾
ㅉㅗㄳ	쪿
ㅉㅗㄴ	쫀
ㅉㅗㄵ	쫁
ㅉㅗㄶ	쫂
ㅉㅗㄷ	쫃
ㅉㅗㄹ	쫄
ㅉㅗㄺ	쫅
ㅉㅗㄻ	쫆
ㅉㅗㄼ	쫇
ㅉㅗㄽ	쫈
ㅉㅗㄾ	쫉
ㅉㅗㄿ	쫊
ㅉㅗㅀ	쫋
ㅉㅗㅁ	쫌
ㅉㅗㅂ	쫍
ㅉㅗㅄ	쫎
ㅉㅗㅅ	쫏
ㅉㅗㅆ	쫐
ㅉㅗㅇ	쫑
ㅉㅗㅈ	쫒
ㅉㅗㅊ	쫓
ㅉㅗㅋ	쫔
ㅉㅗㅌ	쫕
ㅉㅗㅍ	쫖
ㅉㅗㅎ	쫗
ㅉㅘ	쫘
ㅉㅘㄱ	쫙
ㅉㅘㄲ	쫚
ㅉㅘㄳ	쫛
ㅉㅘㄴ	쫜
ㅉㅘㄵ	쫝
ㅉㅘㄶ	쫞
ㅉㅘㄷ	쫟
ㅉㅘㄹ	쫠
ㅉㅘㄺ	쫡
ㅉㅘㄻ	쫢
ㅉㅘㄼ	쫣
ㅉㅘㄽ	쫤
ㅉㅘㄾ	쫥
ㅉㅘㄿ	쫦
ㅉㅘㅀ	쫧
ㅉㅘㅁ	쫨
ㅉㅘㅂ	쫩
ㅉㅘㅄ	쫪
ㅉㅘㅅ	쫫
ㅉㅘㅆ	쫬
ㅉㅘㅇ	쫭
ㅉㅘㅈ	쫮
ㅉㅘㅊ	쫯
ㅉㅘㅋ	쫰
ㅉㅘㅌ	쫱
ㅉㅘㅍ	쫲
ㅉㅘㅎ	쫳
ㅉㅙ	쫴
ㅉㅙㄱ	쫵
ㅉㅙㄲ	쫶
ㅉㅙㄳ	쫷
ㅉㅙㄴ	쫸
ㅉㅙㄵ	쫹
ㅉㅙㄶ	쫺
ㅉㅙㄷ	쫻
ㅉㅙㄹ	쫼
ㅉㅙㄺ	쫽
ㅉㅙㄻ	쫾
ㅉㅙㄼ	쫿
ㅉㅙㄽ	쬀
ㅉㅙㄾ	쬁
ㅉㅙㄿ	쬂
ㅉㅙㅀ	쬃
ㅉㅙㅁ	쬄
ㅉㅙㅂ	쬅
ㅉㅙㅄ	쬆
ㅉㅙㅅ	쬇
ㅉㅙㅆ	쬈
ㅉㅙㅇ	쬉
ㅉㅙㅈ	쬊
ㅉㅙㅊ	쬋
ㅉㅙㅋ	쬌
ㅉㅙㅌ	쬍
ㅉㅙㅍ	쬎
ㅉㅙㅎ	쬏
ㅉㅚ	쬐
ㅉㅚㄱ	쬑
ㅉㅚㄲ	쬒
ㅉㅚㄳ	쬓
ㅉㅚㄴ	쬔
ㅉㅚㄵ	쬕
ㅉㅚㄶ	쬖
ㅉㅚㄷ	쬗
ㅉㅚㄹ	쬘
ㅉㅚㄺ	쬙
ㅉㅚㄻ	쬚
ㅉㅚㄼ	쬛
ㅉㅚㄽ	쬜
ㅉㅚㄾ	쬝
ㅉㅚㄿ	쬞
ㅉㅚㅀ	쬟
ㅉㅚㅁ	쬠
ㅉㅚㅂ	쬡
ㅉㅚㅄ	쬢
ㅉㅚㅅ	쬣
ㅉㅚㅆ	쬤
ㅉㅚㅇ	쬥
ㅉㅚㅈ	쬦
ㅉㅚㅊ	쬧
ㅉㅚㅋ	쬨
ㅉㅚㅌ	쬩
ㅉㅚㅍ	쬪
ㅉㅚㅎ	쬫
ㅉㅛ	쬬
ㅉㅛㄱ	쬭
ㅉㅛㄲ	쬮
ㅉㅛㄳ	쬯
ㅉㅛㄴ	쬰
ㅉㅛㄵ	쬱
ㅉㅛㄶ	쬲
ㅉㅛㄷ	쬳
ㅉㅛㄹ	쬴
ㅉㅛㄺ	쬵
ㅉㅛㄻ	쬶
ㅉㅛㄼ	쬷
ㅉㅛㄽ	쬸
ㅉㅛㄾ	쬹
ㅉㅛㄿ	쬺
ㅉㅛㅀ	쬻
ㅉㅛㅁ	쬼
ㅉㅛㅂ	쬽
ㅉㅛㅄ	쬾
ㅉㅛㅅ	쬿
ㅉㅛㅆ	쭀
ㅉㅛㅇ	쭁
ㅉㅛㅈ	쭂
ㅉㅛㅊ	쭃
ㅉㅛㅋ	쭄
ㅉㅛㅌ	쭅
ㅉㅛㅍ	쭆
ㅉㅛㅎ	쭇
ㅉㅜ	쭈
ㅉㅜㄱ	쭉
ㅉㅜㄲ	쭊
ㅉㅜㄳ	쭋
ㅉㅜㄴ	쭌
ㅉㅜㄵ	쭍
ㅉㅜㄶ	쭎
ㅉㅜㄷ	쭏
ㅉㅜㄹ	쭐
ㅉㅜㄺ	쭑
ㅉㅜㄻ	쭒
ㅉㅜㄼ	쭓
ㅉㅜㄽ	쭔
ㅉㅜㄾ	쭕
ㅉㅜㄿ	쭖
ㅉㅜㅀ	쭗
ㅉㅜㅁ	쭘
ㅉㅜㅂ	쭙
ㅉㅜㅄ	쭚
ㅉㅜㅅ	쭛
ㅉㅜㅆ	쭜
ㅉㅜㅇ	쭝
ㅉㅜㅈ	쭞
ㅉㅜㅊ	쭟
ㅉㅜㅋ	쭠
ㅉㅜㅌ	쭡
ㅉㅜㅍ	쭢
ㅉㅜㅎ	쭣
ㅉㅝ	쭤
ㅉㅝㄱ	쭥
ㅉㅝㄲ	쭦
ㅉㅝㄳ	쭧
ㅉㅝㄴ	쭨
ㅉㅝㄵ	쭩
ㅉㅝㄶ	쭪
ㅉㅝㄷ	쭫
ㅉㅝㄹ	쭬
ㅉㅝㄺ	쭭
ㅉㅝㄻ	쭮
ㅉㅝㄼ	쭯
ㅉㅝㄽ	쭰
ㅉㅝㄾ	쭱
ㅉㅝㄿ	쭲
ㅉㅝㅀ	쭳
ㅉㅝㅁ	쭴
ㅉㅝㅂ	쭵
ㅉㅝㅄ	쭶
ㅉㅝㅅ	쭷
ㅉㅝㅆ	쭸
ㅉㅝㅇ	쭹
ㅉㅝㅈ	쭺
ㅉㅝㅊ	쭻
ㅉㅝㅋ	쭼
ㅉㅝㅌ	쭽
ㅉㅝㅍ	쭾
ㅉㅝㅎ	쭿
ㅉㅞ	쮀
ㅉㅞㄱ	쮁
ㅉㅞㄲ	쮂
ㅉㅞㄳ	쮃
ㅉㅞㄴ	쮄
ㅉㅞㄵ	쮅
ㅉㅞㄶ	쮆
ㅉㅞㄷ	쮇
ㅉㅞㄹ	쮈
ㅉㅞㄺ	쮉
ㅉㅞㄻ	쮊
ㅉㅞㄼ	쮋
ㅉㅞㄽ	쮌
ㅉㅞㄾ	쮍
ㅉㅞㄿ	쮎
ㅉㅞㅀ	쮏
ㅉㅞㅁ	쮐
ㅉㅞㅂ	쮑
ㅉㅞㅄ	쮒
ㅉㅞㅅ	쮓
ㅉㅞㅆ	쮔
ㅉㅞㅇ	쮕
ㅉㅞㅈ	쮖
ㅉㅞㅊ	쮗
ㅉㅞㅋ	쮘
ㅉㅞㅌ	쮙
ㅉㅞㅍ	쮚
ㅉㅞㅎ	쮛
ㅉㅟ	쮜
ㅉㅟㄱ	쮝
ㅉㅟㄲ	쮞
ㅉㅟㄳ	쮟
ㅉㅟㄴ	쮠
ㅉㅟㄵ	쮡
ㅉㅟㄶ	쮢
ㅉㅟㄷ	쮣
ㅉㅟㄹ	쮤
ㅉㅟㄺ	쮥
ㅉㅟㄻ	쮦
ㅉㅟㄼ	쮧
ㅉㅟㄽ	쮨
ㅉㅟㄾ	쮩
ㅉㅟㄿ	쮪
ㅉㅟㅀ	쮫
ㅉㅟㅁ	쮬
ㅉㅟㅂ	쮭
ㅉㅟㅄ	쮮
ㅉㅟㅅ	쮯
ㅉㅟㅆ	쮰
ㅉㅟㅇ	쮱
ㅉㅟㅈ	쮲
ㅉㅟㅊ	쮳
ㅉㅟㅋ	쮴
ㅉㅟㅌ	쮵
ㅉㅟㅍ	쮶
ㅉㅟㅎ	쮷
ㅉㅠ	쮸
ㅉㅠㄱ	쮹
ㅉㅠㄲ	쮺
ㅉㅠㄳ	쮻
ㅉㅠㄴ	쮼
ㅉㅠㄵ	쮽
ㅉㅠㄶ	쮾
ㅉㅠㄷ	쮿
ㅉㅠㄹ	쯀
ㅉㅠㄺ	쯁
ㅉㅠㄻ	쯂
ㅉㅠㄼ	쯃
ㅉㅠㄽ	쯄
ㅉㅠㄾ	쯅
ㅉㅠㄿ	쯆
ㅉㅠㅀ	쯇
ㅉㅠㅁ	쯈
ㅉㅠㅂ	쯉
ㅉㅠㅄ	쯊
ㅉㅠㅅ	쯋
ㅉㅠㅆ	쯌
ㅉㅠㅇ	쯍
ㅉㅠㅈ	쯎
ㅉㅠㅊ	쯏
ㅉㅠㅋ	쯐
ㅉㅠㅌ	쯑
ㅉㅠㅍ	쯒
ㅉㅠㅎ	쯓
ㅉㅡ	쯔
ㅉㅡㄱ	쯕
ㅉㅡㄲ	쯖
ㅉㅡㄳ	쯗
ㅉㅡㄴ	쯘
ㅉㅡㄵ	쯙
ㅉㅡㄶ	쯚
ㅉㅡㄷ	쯛
ㅉㅡㄹ	쯜
ㅉㅡㄺ	쯝
ㅉㅡㄻ	쯞
ㅉㅡㄼ	쯟
ㅉㅡㄽ	쯠
ㅉㅡㄾ	쯡
ㅉㅡㄿ	쯢
ㅉㅡㅀ	쯣
ㅉㅡㅁ	쯤
ㅉㅡㅂ	쯥
ㅉㅡㅄ	쯦
ㅉㅡㅅ	쯧
ㅉㅡㅆ	쯨
ㅉㅡㅇ	쯩
ㅉㅡㅈ	쯪
ㅉㅡㅊ	쯫
ㅉㅡㅋ	쯬
ㅉㅡㅌ	쯭
ㅉㅡㅍ	쯮
ㅉㅡㅎ	쯯
ㅉㅢ	쯰
ㅉㅢㄱ	쯱
ㅉㅢㄲ	쯲
ㅉㅢㄳ	쯳
ㅉㅢㄴ	쯴
ㅉㅢㄵ	쯵
ㅉㅢㄶ	쯶
ㅉㅢㄷ	쯷
ㅉㅢㄹ	쯸
ㅉㅢㄺ	쯹
ㅉㅢㄻ	쯺
ㅉㅢㄼ	쯻
ㅉㅢㄽ	쯼
ㅉㅢㄾ	쯽
ㅉㅢㄿ	쯾
ㅉㅢㅀ	쯿
ㅉㅢㅁ	찀
ㅉㅢㅂ	찁
ㅉㅢㅄ	찂
ㅉㅢㅅ	찃
ㅉㅢㅆ	찄
ㅉㅢㅇ	찅
ㅉㅢㅈ	찆
ㅉㅢㅊ	찇
ㅉㅢㅋ	찈
ㅉㅢㅌ	찉
ㅉㅢㅍ	찊
ㅉㅢㅎ	찋
ㅉㅣ	찌
ㅉㅣㄱ	찍
ㅉㅣㄲ	찎
ㅉㅣㄳ	찏
ㅉㅣㄴ	찐
ㅉㅣㄵ	찑
ㅉㅣㄶ	찒
ㅉㅣㄷ	찓
ㅉㅣㄹ	찔
ㅉㅣㄺ	찕
ㅉㅣㄻ	찖
ㅉㅣㄼ	찗
ㅉㅣㄽ	찘
ㅉㅣㄾ	찙
ㅉㅣㄿ	찚
ㅉㅣㅀ	찛
ㅉㅣㅁ	찜
ㅉㅣㅂ	찝
ㅉㅣㅄ	찞
ㅉㅣㅅ	찟
ㅉㅣㅆ	찠
ㅉㅣㅇ	찡
ㅉㅣㅈ	찢
ㅉㅣㅊ	찣
ㅉㅣㅋ	찤
ㅉㅣㅌ	찥
ㅉㅣㅍ	찦
ㅉㅣㅎ	찧
ㅊㅏ	차
ㅊㅏㄱ	착
ㅊㅏㄲ	찪
ㅊㅏㄳ	찫
ㅊㅏㄴ	찬
ㅊㅏㄵ	찭
ㅊㅏㄶ	찮
ㅊㅏㄷ	찯
ㅊㅏㄹ	찰
ㅊㅏㄺ	찱
ㅊㅏㄻ	찲
ㅊㅏㄼ	찳
ㅊㅏㄽ	찴
ㅊㅏㄾ	찵
ㅊㅏㄿ	찶
ㅊㅏㅀ	찷
ㅊㅏㅁ	참
ㅊㅏㅂ	찹
ㅊㅏㅄ	찺
ㅊㅏㅅ	찻
ㅊㅏㅆ	찼
ㅊㅏㅇ	창
ㅊㅏㅈ	찾
ㅊㅏㅊ	찿
ㅊㅏㅋ	챀
ㅊㅏㅌ	챁
ㅊㅏㅍ	챂
ㅊㅏㅎ	챃
ㅊㅐ	채
ㅊㅐㄱ	책
ㅊㅐㄲ	챆
ㅊㅐㄳ	챇
ㅊㅐㄴ	챈
ㅊㅐㄵ	챉
ㅊㅐㄶ	챊
ㅊㅐㄷ	챋
ㅊㅐㄹ	챌
ㅊㅐㄺ	챍
ㅊㅐㄻ	챎
ㅊㅐㄼ	챏
ㅊㅐㄽ	챐
ㅊㅐㄾ	챑
ㅊㅐㄿ	챒
ㅊㅐㅀ	챓
ㅊㅐㅁ	챔
ㅊㅐㅂ	챕
ㅊㅐㅄ	챖
ㅊㅐㅅ	챗
ㅊㅐㅆ	챘
ㅊㅐㅇ	챙
ㅊㅐㅈ	챚
ㅊㅐㅊ	챛
ㅊㅐㅋ	챜
ㅊㅐㅌ	챝
ㅊㅐㅍ	챞
ㅊㅐㅎ	챟
ㅊㅑ	챠
ㅊㅑㄱ	챡
ㅊㅑㄲ	챢
ㅊㅑㄳ	챣
ㅊㅑㄴ	챤
ㅊㅑㄵ	챥
ㅊㅑㄶ	챦
ㅊㅑㄷ	챧
ㅊㅑㄹ	챨
ㅊㅑㄺ	챩
ㅊㅑㄻ	챪
ㅊㅑㄼ	챫
ㅊㅑㄽ	챬
ㅊㅑㄾ	챭
ㅊㅑㄿ	챮
ㅊㅑㅀ	챯
ㅊㅑㅁ	챰
ㅊㅑㅂ	챱
ㅊㅑㅄ	챲
ㅊㅑㅅ	챳
ㅊㅑㅆ	챴
ㅊㅑㅇ	챵
ㅊㅑㅈ	챶
ㅊㅑㅊ	챷
ㅊㅑㅋ	챸
ㅊㅑㅌ	챹
ㅊㅑㅍ	챺
ㅊㅑㅎ	챻
ㅊㅒ	챼
ㅊㅒㄱ	챽
ㅊㅒㄲ	챾
ㅊㅒㄳ	챿
ㅊㅒㄴ	첀
ㅊㅒㄵ	첁
ㅊㅒㄶ	첂
ㅊㅒㄷ	첃
ㅊㅒㄹ	첄
ㅊㅒㄺ	첅
ㅊㅒㄻ	첆
ㅊㅒㄼ	첇
ㅊㅒㄽ	첈
ㅊㅒㄾ	첉
ㅊㅒㄿ	첊
ㅊㅒㅀ	첋
ㅊㅒㅁ	첌
ㅊㅒㅂ	첍
ㅊㅒㅄ	첎
ㅊㅒㅅ	첏
ㅊㅒㅆ	첐
ㅊㅒㅇ	첑
ㅊㅒㅈ	첒
ㅊㅒㅊ	첓
ㅊㅒㅋ	첔
ㅊㅒㅌ	첕
ㅊㅒㅍ	첖
ㅊㅒㅎ	첗
ㅊㅓ	처
ㅊㅓㄱ	척
ㅊㅓㄲ	첚
ㅊㅓㄳ	첛
ㅊㅓㄴ	천
ㅊㅓㄵ	첝
ㅊㅓㄶ	첞
ㅊㅓㄷ	첟
ㅊㅓㄹ	철
ㅊㅓㄺ	첡
ㅊㅓㄻ	첢
ㅊㅓㄼ	첣
ㅊㅓㄽ	첤
ㅊㅓㄾ	첥
ㅊㅓㄿ	첦
ㅊㅓㅀ	첧
ㅊㅓㅁ	첨
ㅊㅓㅂ	첩
ㅊㅓㅄ	첪
ㅊㅓㅅ	첫
ㅊㅓㅆ	첬
ㅊㅓㅇ	청
ㅊㅓㅈ	첮
ㅊㅓㅊ	첯
ㅊㅓㅋ	첰
ㅊㅓㅌ	첱
ㅊㅓㅍ	첲
ㅊㅓㅎ	첳
ㅊㅔ	체
ㅊㅔㄱ	첵
ㅊㅔㄲ	첶
ㅊㅔㄳ	첷
ㅊㅔㄴ	첸
ㅊㅔㄵ	첹
ㅊㅔㄶ	첺
ㅊㅔㄷ	첻
ㅊㅔㄹ	첼
ㅊㅔㄺ	첽
ㅊㅔㄻ	첾
ㅊㅔㄼ	첿
ㅊㅔㄽ	쳀
ㅊㅔㄾ	쳁
ㅊㅔㄿ	쳂
ㅊㅔㅀ	쳃
ㅊㅔㅁ	쳄
ㅊㅔㅂ	쳅
ㅊㅔㅄ	쳆
ㅊㅔㅅ	쳇
ㅊㅔㅆ	쳈
ㅊㅔㅇ	쳉
ㅊㅔㅈ	쳊
ㅊㅔㅊ	쳋
ㅊㅔㅋ	쳌
ㅊㅔㅌ	쳍
ㅊㅔㅍ	쳎
ㅊㅔㅎ	쳏
ㅊㅕ	쳐
ㅊㅕㄱ	쳑
ㅊㅕㄲ	쳒
ㅊㅕㄳ	쳓
ㅊㅕㄴ	쳔
ㅊㅕㄵ	쳕
ㅊㅕㄶ	쳖
ㅊㅕㄷ	쳗
ㅊㅕㄹ	쳘
ㅊㅕㄺ	쳙
ㅊㅕㄻ	쳚
ㅊㅕㄼ	쳛
ㅊㅕㄽ	쳜
ㅊㅕㄾ	쳝
ㅊㅕㄿ	쳞
ㅊㅕㅀ	쳟
ㅊㅕㅁ	쳠
ㅊㅕㅂ	쳡
ㅊㅕㅄ	쳢
ㅊㅕㅅ	쳣
ㅊㅕㅆ	쳤
ㅊㅕㅇ	쳥
ㅊㅕㅈ	쳦
ㅊㅕㅊ	쳧
ㅊㅕㅋ	쳨
ㅊㅕㅌ	쳩
ㅊㅕㅍ	쳪
ㅊㅕㅎ	쳫
ㅊㅖ	쳬
ㅊㅖㄱ	쳭
ㅊㅖㄲ	쳮
ㅊㅖㄳ	쳯
ㅊㅖㄴ	쳰
ㅊㅖㄵ	쳱
ㅊㅖㄶ	쳲
ㅊㅖㄷ	쳳
ㅊㅖㄹ	쳴
ㅊㅖㄺ	쳵
ㅊㅖㄻ	쳶
ㅊㅖㄼ	쳷
ㅊㅖㄽ	쳸
ㅊㅖㄾ	쳹
ㅊㅖㄿ	쳺
ㅊㅖㅀ	쳻
ㅊㅖㅁ	쳼
ㅊㅖㅂ	쳽
ㅊㅖㅄ	쳾
ㅊㅖㅅ	쳿
ㅊㅖㅆ	촀
ㅊㅖㅇ	촁
ㅊㅖㅈ	촂
ㅊㅖㅊ	촃
ㅊㅖㅋ	촄
ㅊㅖㅌ	촅
ㅊㅖㅍ	촆
ㅊㅖㅎ	촇
ㅊㅗ	초
ㅊㅗㄱ	촉
ㅊㅗㄲ	촊
ㅊㅗㄳ	촋
ㅊㅗㄴ	촌
ㅊㅗㄵ	촍
ㅊㅗㄶ	촎
ㅊㅗㄷ	촏
ㅊㅗㄹ	촐
ㅊㅗㄺ	촑
ㅊㅗㄻ	촒
ㅊㅗㄼ	촓
ㅊㅗㄽ	촔
ㅊㅗㄾ	촕
ㅊㅗㄿ	촖
ㅊㅗㅀ	촗
ㅊㅗㅁ	촘
ㅊㅗㅂ	촙
ㅊㅗㅄ	촚
ㅊㅗㅅ	촛
ㅊㅗㅆ	촜
ㅊㅗㅇ	총
ㅊㅗㅈ	촞
ㅊㅗㅊ	촟
ㅊㅗㅋ	촠
ㅊㅗㅌ	촡
ㅊㅗㅍ	촢
ㅊㅗㅎ	촣
ㅊㅘ	촤
ㅊㅘㄱ	촥
ㅊㅘㄲ	촦
ㅊㅘㄳ	촧
ㅊㅘㄴ	촨
ㅊㅘㄵ	촩
ㅊㅘㄶ	촪
ㅊㅘㄷ	촫
ㅊㅘㄹ	촬
ㅊㅘㄺ	촭
ㅊㅘㄻ	촮
ㅊㅘㄼ	촯
ㅊㅘㄽ	촰
ㅊㅘㄾ	촱
ㅊㅘㄿ	촲
ㅊㅘㅀ	촳
ㅊㅘㅁ	촴
ㅊㅘㅂ	촵
ㅊㅘㅄ	촶
ㅊㅘㅅ	촷
ㅊㅘㅆ	촸
ㅊㅘㅇ	촹
ㅊㅘㅈ	촺
ㅊㅘㅊ	촻
ㅊㅘㅋ	촼
ㅊㅘㅌ	촽
ㅊㅘㅍ	촾
ㅊㅘㅎ	촿
ㅊㅙ	쵀
ㅊㅙㄱ	쵁
ㅊㅙㄲ	쵂
ㅊㅙㄳ	쵃
ㅊㅙㄴ	쵄
ㅊㅙㄵ	쵅
ㅊㅙㄶ	쵆
ㅊㅙㄷ	쵇
ㅊㅙㄹ	쵈
ㅊㅙㄺ	쵉
ㅊㅙㄻ	쵊
ㅊㅙㄼ	쵋
ㅊㅙㄽ	쵌
ㅊㅙㄾ	쵍
ㅊㅙㄿ	쵎
ㅊㅙㅀ	쵏
ㅊㅙㅁ	쵐
ㅊㅙㅂ	쵑
ㅊㅙㅄ	쵒
ㅊㅙㅅ	쵓
ㅊㅙㅆ	쵔
ㅊㅙㅇ	쵕
ㅊㅙㅈ	쵖
ㅊㅙㅊ	쵗
ㅊㅙㅋ	쵘
ㅊㅙㅌ	쵙
ㅊㅙㅍ	쵚
ㅊㅙㅎ	쵛
ㅊㅚ	최
ㅊㅚㄱ	쵝
ㅊㅚㄲ	쵞
ㅊㅚㄳ	쵟
ㅊㅚㄴ	쵠
ㅊㅚㄵ	쵡
ㅊㅚㄶ	쵢
ㅊㅚㄷ	쵣
ㅊㅚㄹ	쵤
ㅊㅚㄺ	쵥
ㅊㅚㄻ	쵦
ㅊㅚㄼ	쵧
ㅊㅚㄽ	쵨
ㅊㅚㄾ	쵩
ㅊㅚㄿ	쵪
ㅊㅚㅀ	쵫
ㅊㅚㅁ	쵬
ㅊㅚㅂ	쵭
ㅊㅚㅄ	쵮
ㅊㅚㅅ	쵯
ㅊㅚㅆ	쵰
ㅊㅚㅇ	쵱
ㅊㅚㅈ	쵲
ㅊㅚㅊ	쵳
ㅊㅚㅋ	쵴
ㅊㅚㅌ	쵵
ㅊㅚㅍ	쵶
ㅊㅚㅎ	쵷
ㅊㅛ	쵸
ㅊㅛㄱ	쵹
ㅊㅛㄲ	쵺
ㅊㅛㄳ	쵻
ㅊㅛㄴ	쵼
ㅊㅛㄵ	쵽
ㅊㅛㄶ	쵾
ㅊㅛㄷ	쵿
ㅊㅛㄹ	춀
ㅊㅛㄺ	춁
ㅊㅛㄻ	춂
ㅊㅛㄼ	춃
ㅊㅛㄽ	춄
ㅊㅛㄾ	춅
ㅊㅛㄿ	춆
ㅊㅛㅀ	춇
ㅊㅛㅁ	춈
ㅊㅛㅂ	춉
ㅊㅛㅄ	춊
ㅊㅛㅅ	춋
ㅊㅛㅆ	춌
ㅊㅛㅇ	춍
ㅊㅛㅈ	춎
ㅊㅛㅊ	춏
ㅊㅛㅋ	춐
ㅊㅛㅌ	춑
ㅊㅛㅍ	춒
ㅊㅛㅎ	춓
ㅊㅜ	추
ㅊㅜㄱ	축
ㅊㅜㄲ	춖
ㅊㅜㄳ	춗
ㅊㅜㄴ	춘
ㅊㅜㄵ	춙
ㅊㅜㄶ	춚
ㅊㅜㄷ	춛
ㅊㅜㄹ	출
ㅊㅜㄺ	춝
ㅊㅜㄻ	춞
ㅊㅜㄼ	춟
ㅊㅜㄽ	춠
ㅊㅜㄾ	춡
ㅊㅜㄿ	춢
ㅊㅜㅀ	춣
ㅊㅜㅁ	춤
ㅊㅜㅂ	춥
ㅊㅜㅄ	춦
ㅊㅜㅅ	춧
ㅊㅜㅆ	춨
ㅊㅜㅇ	충
ㅊㅜㅈ	춪
ㅊㅜㅊ	춫
ㅊㅜㅋ	춬
ㅊㅜㅌ	춭
ㅊㅜㅍ	춮
ㅊㅜㅎ	춯
ㅊㅝ	춰
ㅊㅝㄱ	춱
ㅊㅝㄲ	춲
ㅊㅝㄳ	춳
ㅊㅝㄴ	춴
ㅊㅝㄵ	춵
ㅊㅝㄶ	춶
ㅊㅝㄷ	춷
ㅊㅝㄹ	춸
ㅊㅝㄺ	춹
ㅊㅝㄻ	춺
ㅊㅝㄼ	춻
ㅊㅝㄽ	춼
ㅊㅝㄾ	춽
ㅊㅝㄿ	춾
ㅊㅝㅀ	춿
ㅊㅝㅁ	췀
ㅊㅝㅂ	췁
ㅊㅝㅄ	췂
ㅊㅝㅅ	췃
ㅊㅝㅆ	췄
ㅊㅝㅇ	췅
ㅊㅝㅈ	췆
ㅊㅝㅊ	췇
ㅊㅝㅋ	췈
ㅊㅝㅌ	췉
ㅊㅝㅍ	췊
ㅊㅝㅎ	췋
ㅊㅞ	췌
ㅊㅞㄱ	췍
ㅊㅞㄲ	췎
ㅊㅞㄳ	췏
ㅊㅞㄴ	췐
ㅊㅞㄵ	췑
ㅊㅞㄶ	췒
ㅊㅞㄷ	췓
ㅊㅞㄹ	췔
ㅊㅞㄺ	췕
ㅊㅞㄻ	췖
ㅊㅞㄼ	췗
ㅊㅞㄽ	췘
ㅊㅞㄾ	췙
ㅊㅞㄿ	췚
ㅊㅞㅀ	췛
ㅊㅞㅁ	췜
ㅊㅞㅂ	췝
ㅊㅞㅄ	췞
ㅊㅞㅅ	췟
ㅊㅞㅆ	췠
ㅊㅞㅇ	췡
ㅊㅞㅈ	췢
ㅊㅞㅊ	췣
ㅊㅞㅋ	췤
ㅊㅞㅌ	췥
ㅊㅞㅍ	췦
ㅊㅞㅎ	췧
ㅊㅟ	취
ㅊㅟㄱ	췩
ㅊㅟㄲ	췪
ㅊㅟㄳ	췫
ㅊㅟㄴ	췬
ㅊㅟㄵ	췭
ㅊㅟㄶ	췮
ㅊㅟㄷ	췯
ㅊㅟㄹ	췰
ㅊㅟㄺ	췱
ㅊㅟㄻ	췲
ㅊㅟㄼ	췳
ㅊㅟㄽ	췴
ㅊㅟㄾ	췵
ㅊㅟㄿ	췶
ㅊㅟㅀ	췷
ㅊㅟㅁ	췸
ㅊㅟㅂ	췹
ㅊㅟㅄ	췺
ㅊㅟㅅ	췻
ㅊㅟㅆ	췼
ㅊㅟㅇ	췽
ㅊㅟㅈ	췾
ㅊㅟㅊ	췿
ㅊㅟㅋ	츀
ㅊㅟㅌ	츁
ㅊㅟㅍ	츂
ㅊㅟㅎ	츃
ㅊㅠ	츄
ㅊㅠㄱ	츅
ㅊㅠㄲ	츆
ㅊㅠㄳ	츇
ㅊㅠㄴ	츈
ㅊㅠㄵ	츉
ㅊㅠㄶ	츊
ㅊㅠㄷ	츋
ㅊㅠㄹ	츌
ㅊㅠㄺ	츍
ㅊㅠㄻ	츎
ㅊㅠㄼ	츏
ㅊㅠㄽ	츐
ㅊㅠㄾ	츑
ㅊㅠㄿ	츒
ㅊㅠㅀ	츓
ㅊㅠㅁ	츔
ㅊㅠㅂ	츕
ㅊㅠㅄ	츖
ㅊㅠㅅ	츗
ㅊㅠㅆ	츘
ㅊㅠㅇ	츙
ㅊㅠㅈ	츚
ㅊㅠㅊ	츛
ㅊㅠㅋ	츜
ㅊㅠㅌ	츝
ㅊㅠㅍ	츞
ㅊㅠㅎ	츟
ㅊㅡ	츠
ㅊㅡㄱ	측
ㅊㅡㄲ	츢
ㅊㅡㄳ	츣
ㅊㅡㄴ	츤
ㅊㅡㄵ	츥
ㅊㅡㄶ	츦
ㅊㅡㄷ	츧
ㅊㅡㄹ	츨
ㅊㅡㄺ	츩
ㅊㅡㄻ	츪
ㅊㅡㄼ	츫
ㅊㅡㄽ	츬
ㅊㅡㄾ	츭
ㅊㅡㄿ	츮
ㅊㅡㅀ	츯
ㅊㅡㅁ	츰
ㅊㅡㅂ	츱
ㅊㅡㅄ	츲
ㅊㅡㅅ	츳
ㅊㅡㅆ	츴
ㅊㅡㅇ	층
ㅊㅡㅈ	츶
ㅊㅡㅊ	츷
ㅊㅡㅋ	츸
ㅊㅡㅌ	츹
ㅊㅡㅍ	츺
ㅊㅡㅎ	츻
ㅊㅢ	츼
ㅊㅢㄱ	츽
ㅊㅢㄲ	츾
ㅊㅢㄳ	츿
ㅊㅢㄴ	칀
ㅊㅢㄵ	칁
ㅊㅢㄶ	칂
ㅊㅢㄷ	칃
ㅊㅢㄹ	칄
ㅊㅢㄺ	칅
ㅊㅢㄻ	칆
ㅊㅢㄼ	칇
ㅊㅢㄽ	칈
ㅊㅢㄾ	칉
ㅊㅢㄿ	칊
ㅊㅢㅀ	칋
ㅊㅢㅁ	칌
ㅊㅢㅂ	칍
ㅊㅢㅄ	칎
ㅊㅢㅅ	칏
ㅊㅢㅆ	칐
ㅊㅢㅇ	칑
ㅊㅢㅈ	칒
ㅊㅢㅊ	칓
ㅊㅢㅋ	칔
ㅊㅢㅌ	칕
ㅊㅢㅍ	칖
ㅊㅢㅎ	칗
ㅊㅣ	치
ㅊㅣㄱ	칙
ㅊㅣㄲ	칚
ㅊㅣㄳ	칛
ㅊㅣㄴ	친
ㅊㅣㄵ	칝
ㅊㅣㄶ	칞
ㅊㅣㄷ	칟
ㅊㅣㄹ	칠
ㅊㅣㄺ	칡
ㅊㅣㄻ	칢
ㅊㅣㄼ	칣
ㅊㅣㄽ	칤
ㅊㅣㄾ	칥
ㅊㅣㄿ	칦
ㅊㅣㅀ	칧
ㅊㅣㅁ	침
ㅊㅣㅂ	칩
ㅊㅣㅄ	칪
ㅊㅣㅅ	칫
ㅊㅣㅆ	칬
ㅊㅣㅇ	칭
ㅊㅣㅈ	칮
ㅊㅣㅊ	칯
ㅊㅣㅋ	칰
ㅊㅣㅌ	칱
ㅊㅣㅍ	칲
ㅊㅣㅎ	칳
ㅋㅏ	카
ㅋㅏㄱ	칵
ㅋㅏㄲ	칶
ㅋㅏㄳ	칷
ㅋㅏㄴ	칸
ㅋㅏㄵ	칹
ㅋㅏㄶ	칺
ㅋㅏㄷ	칻
ㅋㅏㄹ	칼
ㅋㅏㄺ	칽
ㅋㅏㄻ	칾
ㅋㅏㄼ	칿
ㅋㅏㄽ	캀
ㅋㅏㄾ	캁
ㅋㅏㄿ	캂
ㅋㅏㅀ	캃
ㅋㅏㅁ	캄
ㅋㅏㅂ	캅
ㅋㅏㅄ	캆
ㅋㅏㅅ	캇
ㅋㅏㅆ	캈
ㅋㅏㅇ	캉
ㅋㅏㅈ	캊
ㅋㅏㅊ	캋
ㅋㅏㅋ	캌
ㅋㅏㅌ	캍
ㅋㅏㅍ	캎
ㅋㅏㅎ	캏
ㅋㅐ	캐
ㅋㅐㄱ	캑
ㅋㅐㄲ	캒
ㅋㅐㄳ	캓
ㅋㅐㄴ	캔
ㅋㅐㄵ	캕
ㅋㅐㄶ	캖
ㅋㅐㄷ	캗
ㅋㅐㄹ	캘
ㅋㅐㄺ	캙
ㅋㅐㄻ	캚
ㅋㅐㄼ	캛
ㅋㅐㄽ	캜
ㅋㅐㄾ	캝
ㅋㅐㄿ	캞
ㅋㅐㅀ	캟
ㅋㅐㅁ	캠
ㅋㅐㅂ	캡
ㅋㅐㅄ	캢
ㅋㅐㅅ	캣
ㅋㅐㅆ	캤
ㅋㅐㅇ	캥
ㅋㅐㅈ	캦
ㅋㅐㅊ	캧
ㅋㅐㅋ	캨
ㅋㅐㅌ	캩
ㅋㅐㅍ	캪
ㅋㅐㅎ	캫
ㅋㅑ	캬
ㅋㅑㄱ	캭
ㅋㅑㄲ	캮
ㅋㅑㄳ	캯
ㅋㅑㄴ	캰
ㅋㅑㄵ	캱
ㅋㅑㄶ	캲
ㅋㅑㄷ	캳
ㅋㅑㄹ	캴
ㅋㅑㄺ	캵
ㅋㅑㄻ	캶
ㅋㅑㄼ	캷
ㅋㅑㄽ	캸
ㅋㅑㄾ	캹
ㅋㅑㄿ	캺
ㅋㅑㅀ	캻
ㅋㅑㅁ	캼
ㅋㅑㅂ	캽
ㅋㅑㅄ	캾
ㅋㅑㅅ	캿
ㅋㅑㅆ	컀
ㅋㅑㅇ	컁
ㅋㅑㅈ	컂
ㅋㅑㅊ	컃
ㅋㅑㅋ	컄
ㅋㅑㅌ	컅
ㅋㅑㅍ	컆
ㅋㅑㅎ	컇
ㅋㅒ	컈
ㅋㅒㄱ	컉
ㅋㅒㄲ	컊
ㅋㅒㄳ	컋
ㅋㅒㄴ	컌
ㅋㅒㄵ	컍
ㅋㅒㄶ	컎
ㅋㅒㄷ	컏
ㅋㅒㄹ	컐
ㅋㅒㄺ	컑
ㅋㅒㄻ	컒
ㅋㅒㄼ	컓
ㅋㅒㄽ	컔
ㅋㅒㄾ	컕
ㅋㅒㄿ	컖
ㅋㅒㅀ	컗
ㅋㅒㅁ	컘
ㅋㅒㅂ	컙
ㅋㅒㅄ	컚
ㅋㅒㅅ	컛
ㅋㅒㅆ	컜
ㅋㅒㅇ	컝
ㅋㅒㅈ	컞
ㅋㅒㅊ	컟
ㅋㅒㅋ	컠
ㅋㅒㅌ	컡
ㅋㅒㅍ	컢
ㅋㅒㅎ	컣
ㅋㅓ	커
ㅋㅓㄱ	컥
ㅋㅓㄲ	컦
ㅋㅓㄳ	컧
ㅋㅓㄴ	컨
ㅋㅓㄵ	컩
ㅋㅓㄶ	컪
ㅋㅓㄷ	컫
ㅋㅓㄹ	컬
ㅋㅓㄺ	컭
ㅋㅓㄻ	컮
ㅋㅓㄼ	컯
ㅋㅓㄽ	컰
ㅋㅓㄾ	컱
ㅋㅓㄿ	컲
ㅋㅓㅀ	컳
ㅋㅓㅁ	컴
ㅋㅓㅂ	컵
ㅋㅓㅄ	컶
ㅋㅓㅅ	컷
ㅋㅓㅆ	컸
ㅋㅓㅇ	컹
ㅋㅓㅈ	컺
ㅋㅓㅊ	컻
ㅋㅓㅋ	컼
ㅋㅓㅌ	컽
ㅋㅓㅍ	컾
ㅋㅓㅎ	컿
ㅋㅔ	케
ㅋㅔㄱ	켁
ㅋㅔㄲ	켂
ㅋㅔㄳ	켃
ㅋㅔㄴ	켄
ㅋㅔㄵ	켅
ㅋㅔㄶ	켆
ㅋㅔㄷ	켇
ㅋㅔㄹ	켈
ㅋㅔㄺ	켉
ㅋㅔㄻ	켊
ㅋㅔㄼ	켋
ㅋㅔㄽ	켌
ㅋㅔㄾ	켍
ㅋㅔㄿ	켎
ㅋㅔㅀ	켏
ㅋㅔㅁ	켐
ㅋㅔㅂ	켑
ㅋㅔㅄ	켒
ㅋㅔㅅ	켓
ㅋㅔㅆ	켔
ㅋㅔㅇ	켕
ㅋㅔㅈ	켖
ㅋㅔㅊ	켗
ㅋㅔㅋ	켘
ㅋㅔㅌ	켙
ㅋㅔㅍ	켚
ㅋㅔㅎ	켛
ㅋㅕ	켜
ㅋㅕㄱ	켝
ㅋㅕㄲ	켞
ㅋㅕㄳ	켟
ㅋㅕㄴ	켠
ㅋㅕㄵ	켡
ㅋㅕㄶ	켢
ㅋㅕㄷ	켣
ㅋㅕㄹ	켤
ㅋㅕㄺ	켥
ㅋㅕㄻ	켦
ㅋㅕㄼ	켧
ㅋㅕㄽ	켨
ㅋㅕㄾ	켩
ㅋㅕㄿ	켪
ㅋㅕㅀ	켫
ㅋㅕㅁ	켬
ㅋㅕㅂ	켭
ㅋㅕㅄ	켮
ㅋㅕㅅ	켯
ㅋㅕㅆ	켰
ㅋㅕㅇ	켱
ㅋㅕㅈ	켲
ㅋㅕㅊ	켳
ㅋㅕㅋ	켴
ㅋㅕㅌ	켵
ㅋㅕㅍ	켶
ㅋㅕㅎ	켷
ㅋㅖ	켸
ㅋㅖㄱ	켹
ㅋㅖㄲ	켺
ㅋㅖㄳ	켻
ㅋㅖㄴ	켼
ㅋㅖㄵ	켽
ㅋㅖㄶ	켾
ㅋㅖㄷ	켿
ㅋㅖㄹ	콀
ㅋㅖㄺ	콁
ㅋㅖㄻ	콂
ㅋㅖㄼ	콃
ㅋㅖㄽ	콄
ㅋㅖㄾ	콅
ㅋㅖㄿ	콆
ㅋㅖㅀ	콇
ㅋㅖㅁ	콈
ㅋㅖㅂ	콉
ㅋㅖㅄ	콊
ㅋㅖㅅ	콋
ㅋㅖㅆ	콌
ㅋㅖㅇ	콍
ㅋㅖㅈ	콎
ㅋㅖㅊ	콏
ㅋㅖㅋ	콐
ㅋㅖㅌ	콑
ㅋㅖㅍ	콒
ㅋㅖㅎ	콓
ㅋㅗ	코
ㅋㅗㄱ	콕
ㅋㅗㄲ	콖
ㅋㅗㄳ	콗
ㅋㅗㄴ	콘
ㅋㅗㄵ	콙
ㅋㅗㄶ	콚
ㅋㅗㄷ	콛
ㅋㅗㄹ	콜
ㅋㅗㄺ	콝
ㅋㅗㄻ	콞
ㅋㅗㄼ	콟
ㅋㅗㄽ	콠
ㅋㅗㄾ	콡
ㅋㅗㄿ	콢
ㅋㅗㅀ	콣
ㅋㅗㅁ	콤
ㅋㅗㅂ	콥
ㅋㅗㅄ	콦
ㅋㅗㅅ	콧
ㅋㅗㅆ	콨
ㅋㅗㅇ	콩
ㅋㅗㅈ	콪
ㅋㅗㅊ	콫
ㅋㅗㅋ	콬
ㅋㅗㅌ	콭
ㅋㅗㅍ	콮
ㅋㅗㅎ	콯
ㅋㅘ	콰
ㅋㅘㄱ	콱
ㅋㅘㄲ	콲
ㅋㅘㄳ	콳
ㅋㅘㄴ	콴
ㅋㅘㄵ	콵
ㅋㅘㄶ	콶
ㅋㅘㄷ	콷
ㅋㅘㄹ	콸
ㅋㅘㄺ	콹
ㅋㅘㄻ	콺
ㅋㅘㄼ	콻
ㅋㅘㄽ	콼
ㅋㅘㄾ	콽
ㅋㅘㄿ	콾
ㅋㅘㅀ	콿
ㅋㅘㅁ	쾀
ㅋㅘㅂ	쾁
ㅋㅘㅄ	쾂
ㅋㅘㅅ	쾃
ㅋㅘㅆ	쾄
ㅋㅘㅇ	쾅
ㅋㅘㅈ	쾆
ㅋㅘㅊ	쾇
ㅋㅘㅋ	쾈
ㅋㅘㅌ	쾉
ㅋㅘㅍ	쾊
ㅋㅘㅎ	쾋
ㅋㅙ	쾌
ㅋㅙㄱ	쾍
ㅋㅙㄲ	쾎
ㅋㅙㄳ	쾏
ㅋㅙㄴ	쾐
ㅋㅙㄵ	쾑
ㅋㅙㄶ	쾒
ㅋㅙㄷ	쾓
ㅋㅙㄹ	쾔
ㅋㅙㄺ	쾕
ㅋㅙㄻ	쾖
ㅋㅙㄼ	쾗
ㅋㅙㄽ	쾘
ㅋㅙㄾ	쾙
ㅋㅙㄿ	쾚
ㅋㅙㅀ	쾛
ㅋㅙㅁ	쾜
ㅋㅙㅂ	쾝
ㅋㅙㅄ	쾞
ㅋㅙㅅ	쾟
ㅋㅙㅆ	쾠
ㅋㅙㅇ	쾡
ㅋㅙㅈ	쾢
ㅋㅙㅊ	쾣
ㅋㅙㅋ	쾤
ㅋㅙㅌ	쾥
ㅋㅙㅍ	쾦
ㅋㅙㅎ	쾧
ㅋㅚ	쾨
ㅋㅚㄱ	쾩
ㅋㅚㄲ	쾪
ㅋㅚㄳ	쾫
ㅋㅚㄴ	쾬
ㅋㅚㄵ	쾭
ㅋㅚㄶ	쾮
ㅋㅚㄷ	쾯
ㅋㅚㄹ	쾰
ㅋㅚㄺ	쾱
ㅋㅚㄻ	쾲
ㅋㅚㄼ	쾳
ㅋㅚㄽ	쾴
ㅋㅚㄾ	쾵
ㅋㅚㄿ	쾶
ㅋㅚㅀ	쾷
ㅋㅚㅁ	쾸
ㅋㅚㅂ	쾹
ㅋㅚㅄ	쾺
ㅋㅚㅅ	쾻
ㅋㅚㅆ	쾼
ㅋㅚㅇ	쾽
ㅋㅚㅈ	쾾
ㅋㅚㅊ	쾿
ㅋㅚㅋ	쿀
ㅋㅚㅌ	쿁
ㅋㅚㅍ	쿂
ㅋㅚㅎ	쿃
ㅋㅛ	쿄
ㅋㅛㄱ	쿅
ㅋㅛㄲ	쿆
ㅋㅛㄳ	쿇
ㅋㅛㄴ	쿈
ㅋㅛㄵ	쿉
ㅋㅛㄶ	쿊
ㅋㅛㄷ	쿋
ㅋㅛㄹ	쿌
ㅋㅛㄺ	쿍
ㅋㅛㄻ	쿎
ㅋㅛㄼ	쿏
ㅋㅛㄽ	쿐
ㅋㅛㄾ	쿑
ㅋㅛㄿ	쿒
ㅋㅛㅀ	쿓
ㅋㅛㅁ	쿔
ㅋㅛㅂ	쿕
ㅋㅛㅄ	쿖
ㅋㅛㅅ	쿗
ㅋㅛㅆ	쿘
ㅋㅛㅇ	쿙
ㅋㅛㅈ	쿚
ㅋㅛㅊ	쿛
ㅋㅛㅋ	쿜
ㅋㅛㅌ	쿝
ㅋㅛㅍ	쿞
ㅋㅛㅎ	쿟
ㅋㅜ	쿠
ㅋㅜㄱ	쿡
ㅋㅜㄲ	쿢
ㅋㅜㄳ	쿣
ㅋㅜㄴ	쿤
ㅋㅜㄵ	쿥
ㅋㅜㄶ	쿦
ㅋㅜㄷ	쿧
ㅋㅜㄹ	쿨
ㅋㅜㄺ	쿩
ㅋㅜㄻ	쿪
ㅋㅜㄼ	쿫
ㅋㅜㄽ	쿬
ㅋㅜㄾ	쿭
ㅋㅜㄿ	쿮
ㅋㅜㅀ	쿯
ㅋㅜㅁ	쿰
ㅋㅜㅂ	쿱
ㅋㅜㅄ	쿲
ㅋㅜㅅ	쿳
ㅋㅜㅆ	쿴
ㅋㅜㅇ	쿵
ㅋㅜㅈ	쿶
ㅋㅜㅊ	쿷
ㅋㅜㅋ	쿸
ㅋㅜㅌ	쿹
ㅋㅜㅍ	쿺
ㅋㅜㅎ	쿻
ㅋㅝ	쿼
ㅋㅝㄱ	쿽
ㅋㅝㄲ	쿾
ㅋㅝㄳ	쿿
ㅋㅝㄴ	퀀
ㅋㅝㄵ	퀁
ㅋㅝㄶ	퀂
ㅋㅝㄷ	퀃
ㅋㅝㄹ	퀄
ㅋㅝㄺ	퀅
ㅋㅝㄻ	퀆
ㅋㅝㄼ	퀇
ㅋㅝㄽ	퀈
ㅋㅝㄾ	퀉
ㅋㅝㄿ	퀊
ㅋㅝㅀ	퀋
ㅋㅝㅁ	퀌
ㅋㅝㅂ	퀍
ㅋㅝㅄ	퀎
ㅋㅝㅅ	퀏
ㅋㅝㅆ	퀐
ㅋㅝㅇ	퀑
ㅋㅝㅈ	퀒
ㅋㅝㅊ	퀓
ㅋㅝㅋ	퀔
ㅋㅝㅌ	퀕
ㅋㅝㅍ	퀖
ㅋㅝㅎ	퀗
ㅋㅞ	퀘
ㅋㅞㄱ	퀙
ㅋㅞㄲ	퀚
ㅋㅞㄳ	퀛
ㅋㅞㄴ	퀜
ㅋㅞㄵ	퀝
ㅋㅞㄶ	퀞
ㅋㅞㄷ	퀟
ㅋㅞㄹ	퀠
ㅋㅞㄺ	퀡
ㅋㅞㄻ	퀢
ㅋㅞㄼ	퀣
ㅋㅞㄽ	퀤
ㅋㅞㄾ	퀥
ㅋㅞㄿ	퀦
ㅋㅞㅀ	퀧
ㅋㅞㅁ	퀨
ㅋㅞㅂ	퀩
ㅋㅞㅄ	퀪
ㅋㅞㅅ	퀫
ㅋㅞㅆ	퀬
ㅋㅞㅇ	퀭
ㅋㅞㅈ	퀮
ㅋㅞㅊ	퀯
ㅋㅞㅋ	퀰
ㅋㅞㅌ	퀱
ㅋㅞㅍ	퀲
ㅋㅞㅎ	퀳
ㅋㅟ	퀴
ㅋㅟㄱ	퀵
ㅋㅟㄲ	퀶
ㅋㅟㄳ	퀷
ㅋㅟㄴ	퀸
ㅋㅟㄵ	퀹
ㅋㅟㄶ	퀺
ㅋㅟㄷ	퀻
ㅋㅟㄹ	퀼
ㅋㅟㄺ	퀽
ㅋㅟㄻ	퀾
ㅋㅟㄼ	퀿
ㅋㅟㄽ	큀
ㅋㅟㄾ	큁
ㅋㅟㄿ	큂
ㅋㅟㅀ	큃
ㅋㅟㅁ	큄
ㅋㅟㅂ	큅
ㅋㅟㅄ	큆
ㅋㅟㅅ	큇
ㅋㅟㅆ	큈
ㅋㅟㅇ	큉
ㅋㅟㅈ	큊
ㅋㅟㅊ	큋
ㅋㅟㅋ	큌
ㅋㅟㅌ	큍
ㅋㅟㅍ	큎
ㅋㅟㅎ	큏
ㅋㅠ	큐
ㅋㅠㄱ	큑
ㅋㅠㄲ	큒
ㅋㅠㄳ	큓
ㅋㅠㄴ	큔
ㅋㅠㄵ	큕
ㅋㅠㄶ	큖
ㅋㅠㄷ	큗
ㅋㅠㄹ	큘
ㅋㅠㄺ	큙
ㅋㅠㄻ	큚
ㅋㅠㄼ	큛
ㅋㅠㄽ	큜
ㅋㅠㄾ	큝
ㅋㅠㄿ	큞
ㅋㅠㅀ	큟
ㅋㅠㅁ	큠
ㅋㅠㅂ	큡
ㅋㅠㅄ	큢
ㅋㅠㅅ	큣
ㅋㅠㅆ	큤
ㅋㅠㅇ	큥
ㅋㅠㅈ	큦
ㅋㅠㅊ	큧
ㅋㅠㅋ	큨
ㅋㅠㅌ	큩
ㅋㅠㅍ	큪
ㅋㅠㅎ	큫
ㅋㅡ	크
ㅋㅡㄱ	큭
ㅋㅡㄲ	큮
ㅋㅡㄳ	큯
ㅋㅡㄴ	큰
ㅋㅡㄵ	큱
ㅋㅡㄶ	큲
ㅋㅡㄷ	큳
ㅋㅡㄹ	클
ㅋㅡㄺ	큵
ㅋㅡㄻ	큶
ㅋㅡㄼ	큷
ㅋㅡㄽ	큸
ㅋㅡㄾ	큹
ㅋㅡㄿ	큺
ㅋㅡㅀ	큻
ㅋㅡㅁ	큼
ㅋㅡㅂ	큽
ㅋㅡㅄ	큾
ㅋㅡㅅ	큿
ㅋㅡㅆ	킀
ㅋㅡㅇ	킁
ㅋㅡㅈ	킂
ㅋㅡㅊ	킃
ㅋㅡㅋ	킄
ㅋㅡㅌ	킅
ㅋㅡㅍ	킆
ㅋㅡㅎ	킇
ㅋㅢ	킈
ㅋㅢㄱ	킉
ㅋㅢㄲ	킊
ㅋㅢㄳ	킋
ㅋㅢㄴ	킌
ㅋㅢㄵ	킍
ㅋㅢㄶ	킎
ㅋㅢㄷ	킏
ㅋㅢㄹ	킐
ㅋㅢㄺ	킑
ㅋㅢㄻ	킒
ㅋㅢㄼ	킓
ㅋㅢㄽ	킔
ㅋㅢㄾ	킕
ㅋㅢㄿ	킖
ㅋㅢㅀ	킗
ㅋㅢㅁ	킘
ㅋㅢㅂ	킙
ㅋㅢㅄ	킚
ㅋㅢㅅ	킛
ㅋㅢㅆ	킜
ㅋㅢㅇ	킝
ㅋㅢㅈ	킞
ㅋㅢㅊ	킟
ㅋㅢㅋ	킠
ㅋㅢㅌ	킡
ㅋㅢㅍ	킢
ㅋㅢㅎ	킣
ㅋㅣ	키
ㅋㅣㄱ	킥
ㅋㅣㄲ	킦
ㅋㅣㄳ	킧
ㅋㅣㄴ	킨
ㅋㅣㄵ	킩
ㅋㅣㄶ	킪
ㅋㅣㄷ	킫
ㅋㅣㄹ	킬
ㅋㅣㄺ	킭
ㅋㅣㄻ	킮
ㅋㅣㄼ	킯
ㅋㅣㄽ	킰
ㅋㅣㄾ	킱
ㅋㅣㄿ	킲
ㅋㅣㅀ	킳
ㅋㅣㅁ	킴
ㅋㅣㅂ	킵
ㅋㅣㅄ	킶
ㅋㅣㅅ	킷
ㅋㅣㅆ	킸
ㅋㅣㅇ	킹
ㅋㅣㅈ	킺
ㅋㅣㅊ	킻
ㅋㅣㅋ	킼
ㅋㅣㅌ	킽
ㅋㅣㅍ	킾
ㅋㅣㅎ	킿
ㅌㅏ	타
ㅌㅏㄱ	탁
ㅌㅏㄲ	탂
ㅌㅏㄳ	탃
ㅌㅏㄴ	탄
ㅌㅏㄵ	탅
ㅌㅏㄶ	탆
ㅌㅏㄷ	탇
ㅌㅏㄹ	탈
ㅌㅏㄺ	탉
ㅌㅏㄻ	탊
ㅌㅏㄼ	탋
ㅌㅏㄽ	탌
ㅌㅏㄾ	탍
ㅌㅏㄿ	탎
ㅌㅏㅀ	탏
ㅌㅏㅁ	탐
ㅌㅏㅂ	탑
ㅌㅏㅄ	탒
ㅌㅏㅅ	탓
ㅌㅏㅆ	탔
ㅌㅏㅇ	탕
ㅌㅏㅈ	탖
ㅌㅏㅊ	탗
ㅌㅏㅋ	탘
ㅌㅏㅌ	탙
ㅌㅏㅍ	탚
ㅌㅏㅎ	탛
ㅌㅐ	태
ㅌㅐㄱ	택
ㅌㅐㄲ	탞
ㅌㅐㄳ	탟
ㅌㅐㄴ	탠
ㅌㅐㄵ	탡
ㅌㅐㄶ	탢
ㅌㅐㄷ	탣
ㅌㅐㄹ	탤
ㅌㅐㄺ	탥
ㅌㅐㄻ	탦
ㅌㅐㄼ	탧
ㅌㅐㄽ	탨
ㅌㅐㄾ	탩
ㅌㅐㄿ	탪
ㅌㅐㅀ	탫
ㅌㅐㅁ	탬
ㅌㅐㅂ	탭
ㅌㅐㅄ	탮
ㅌㅐㅅ	탯
ㅌㅐㅆ	탰
ㅌㅐㅇ	탱
ㅌㅐㅈ	탲
ㅌㅐㅊ	탳
ㅌㅐㅋ	탴
ㅌㅐㅌ	탵
ㅌㅐㅍ	탶
ㅌㅐㅎ	탷
ㅌㅑ	탸
ㅌㅑㄱ	탹
ㅌㅑㄲ	탺
ㅌㅑㄳ	탻
ㅌㅑㄴ	탼
ㅌㅑㄵ	탽
ㅌㅑㄶ	탾
ㅌㅑㄷ	탿
ㅌㅑㄹ	턀
ㅌㅑㄺ	턁
ㅌㅑㄻ	턂
ㅌㅑㄼ	턃
ㅌㅑㄽ	턄
ㅌㅑㄾ	턅
ㅌㅑㄿ	턆
ㅌㅑㅀ	턇
ㅌㅑㅁ	턈
ㅌㅑㅂ	턉
ㅌㅑㅄ	턊
ㅌㅑㅅ	턋
ㅌㅑㅆ	턌
ㅌㅑㅇ	턍
ㅌㅑㅈ	턎
ㅌㅑㅊ	턏
ㅌㅑㅋ	턐
ㅌㅑㅌ	턑
ㅌㅑㅍ	턒
ㅌㅑㅎ	턓
ㅌㅒ	턔
ㅌㅒㄱ	턕
ㅌㅒㄲ	턖
ㅌㅒㄳ	턗
ㅌㅒㄴ	턘
ㅌㅒㄵ	턙
ㅌㅒㄶ	턚
ㅌㅒㄷ	턛
ㅌㅒㄹ	턜
ㅌㅒㄺ	턝
ㅌㅒㄻ	턞
ㅌㅒㄼ	턟
ㅌㅒㄽ	턠
ㅌㅒㄾ	턡
ㅌㅒㄿ	턢
ㅌㅒㅀ	턣
ㅌㅒㅁ	턤
ㅌㅒㅂ	턥
ㅌㅒㅄ	턦
ㅌㅒㅅ	턧
ㅌㅒㅆ	턨
ㅌㅒㅇ	턩
ㅌㅒㅈ	턪
ㅌㅒㅊ	턫
ㅌㅒㅋ	턬
ㅌㅒㅌ	턭
ㅌㅒㅍ	턮
ㅌㅒㅎ	턯
ㅌㅓ	터
ㅌㅓㄱ	턱
ㅌㅓㄲ	턲
ㅌㅓㄳ	턳
ㅌㅓㄴ	턴
ㅌㅓㄵ	턵
ㅌㅓㄶ	턶
ㅌㅓㄷ	턷
ㅌㅓㄹ	털
ㅌㅓㄺ	턹
ㅌㅓㄻ	턺
ㅌㅓㄼ	턻
ㅌㅓㄽ	턼
ㅌㅓㄾ	턽
ㅌㅓㄿ	턾
ㅌㅓㅀ	턿
ㅌㅓㅁ	텀
ㅌㅓㅂ	텁
ㅌㅓㅄ	텂
ㅌㅓㅅ	텃
ㅌㅓㅆ	텄
ㅌㅓㅇ	텅
ㅌㅓㅈ	텆
ㅌㅓㅊ	텇
ㅌㅓㅋ	텈
ㅌㅓㅌ	텉
ㅌㅓㅍ	텊
ㅌㅓㅎ	텋
ㅌㅔ	테
ㅌㅔㄱ	텍
ㅌㅔㄲ	텎
ㅌㅔㄳ	텏
ㅌㅔㄴ	텐
ㅌㅔㄵ	텑
ㅌㅔㄶ	텒
ㅌㅔㄷ	텓
ㅌㅔㄹ	텔
ㅌㅔㄺ	텕
ㅌㅔㄻ	텖
ㅌㅔㄼ	텗
ㅌㅔㄽ	텘
ㅌㅔㄾ	텙
ㅌㅔㄿ	텚
ㅌㅔㅀ	텛
ㅌㅔㅁ	템
ㅌㅔㅂ	텝
ㅌㅔㅄ	텞
ㅌㅔㅅ	텟
ㅌㅔㅆ	텠
ㅌㅔㅇ	텡
ㅌㅔㅈ	텢
ㅌㅔㅊ	텣
ㅌㅔㅋ	텤
ㅌㅔㅌ	텥
ㅌㅔㅍ	텦
ㅌㅔㅎ	텧
ㅌㅕ	텨
ㅌㅕㄱ	텩
ㅌㅕㄲ	텪
ㅌㅕㄳ	텫
ㅌㅕㄴ	텬
ㅌㅕㄵ	텭
ㅌㅕㄶ	텮
ㅌㅕㄷ	텯
ㅌㅕㄹ	텰
ㅌㅕㄺ	텱
ㅌㅕㄻ	텲
ㅌㅕㄼ	텳
ㅌㅕㄽ	텴
ㅌㅕㄾ	텵
ㅌㅕㄿ	텶
ㅌㅕㅀ	텷
ㅌㅕㅁ	텸
ㅌㅕㅂ	텹
ㅌㅕㅄ	텺
ㅌㅕㅅ	텻
ㅌㅕㅆ	텼
ㅌㅕㅇ	텽
ㅌㅕㅈ	텾
ㅌㅕㅊ	텿
ㅌㅕㅋ	톀
ㅌㅕㅌ	톁
ㅌㅕㅍ	톂
ㅌㅕㅎ	톃
ㅌㅖ	톄
ㅌㅖㄱ	톅
ㅌㅖㄲ	톆
ㅌㅖㄳ	톇
ㅌㅖㄴ	톈
ㅌㅖㄵ	톉
ㅌㅖㄶ	톊
ㅌㅖㄷ	톋
ㅌㅖㄹ	톌
ㅌㅖㄺ	톍
ㅌㅖㄻ	톎
ㅌㅖㄼ	톏
ㅌㅖㄽ	톐
ㅌㅖㄾ	톑
ㅌㅖㄿ	톒
ㅌㅖㅀ	톓
ㅌㅖㅁ	톔
ㅌㅖㅂ	톕
ㅌㅖㅄ	톖
ㅌㅖㅅ	톗
ㅌㅖㅆ	톘
ㅌㅖㅇ	톙
ㅌㅖㅈ	톚
ㅌㅖㅊ	톛
ㅌㅖㅋ	톜
ㅌㅖㅌ	톝
ㅌㅖㅍ	톞
ㅌㅖㅎ	톟
ㅌㅗ	토
ㅌㅗㄱ	톡
ㅌㅗㄲ	톢
ㅌㅗㄳ	톣
ㅌㅗㄴ	톤
ㅌㅗㄵ	톥
ㅌㅗㄶ	톦
ㅌㅗㄷ	톧
ㅌㅗㄹ	톨
ㅌㅗㄺ	톩
ㅌㅗㄻ	톪
ㅌㅗㄼ	톫
ㅌㅗㄽ	톬
ㅌㅗㄾ	톭
ㅌㅗㄿ	톮
ㅌㅗㅀ	톯
ㅌㅗㅁ	톰
ㅌㅗㅂ	톱
ㅌㅗㅄ	톲
ㅌㅗㅅ	톳
ㅌㅗㅆ	톴
ㅌㅗㅇ	통
ㅌㅗㅈ	톶
ㅌㅗㅊ	톷
ㅌㅗㅋ	톸
ㅌㅗㅌ	톹
ㅌㅗㅍ	톺
ㅌㅗㅎ	톻
ㅌㅘ	톼
ㅌㅘㄱ	톽
ㅌㅘㄲ	톾
ㅌㅘㄳ	톿
ㅌㅘㄴ	퇀
ㅌㅘㄵ	퇁
ㅌㅘㄶ	퇂
ㅌㅘㄷ	퇃
ㅌㅘㄹ	퇄
ㅌㅘㄺ	퇅
ㅌㅘㄻ	퇆
ㅌㅘㄼ	퇇
ㅌㅘㄽ	퇈
ㅌㅘㄾ	퇉
ㅌㅘㄿ	퇊
ㅌㅘㅀ	퇋
ㅌㅘㅁ	퇌
ㅌㅘㅂ	퇍
ㅌㅘㅄ	퇎
ㅌㅘㅅ	퇏
ㅌㅘㅆ	퇐
ㅌㅘㅇ	퇑
ㅌㅘㅈ	퇒
ㅌㅘㅊ	퇓
ㅌㅘㅋ	퇔
ㅌㅘㅌ	퇕
ㅌㅘㅍ	퇖
ㅌㅘㅎ	퇗
ㅌㅙ	퇘
ㅌㅙㄱ	퇙
ㅌㅙㄲ	퇚
ㅌㅙㄳ	퇛
ㅌㅙㄴ	퇜
ㅌㅙㄵ	퇝
ㅌㅙㄶ	퇞
ㅌㅙㄷ	퇟
ㅌㅙㄹ	퇠
ㅌㅙㄺ	퇡
ㅌㅙㄻ	퇢
ㅌㅙㄼ	퇣
ㅌㅙㄽ	퇤
ㅌㅙㄾ	퇥
ㅌㅙㄿ	퇦
ㅌㅙㅀ	퇧
ㅌㅙㅁ	퇨
ㅌㅙㅂ	퇩
ㅌㅙㅄ	퇪
ㅌㅙㅅ	퇫
ㅌㅙㅆ	퇬
ㅌㅙㅇ	퇭
ㅌㅙㅈ	퇮
ㅌㅙㅊ	퇯
ㅌㅙㅋ	퇰
ㅌㅙㅌ	퇱
ㅌㅙㅍ	퇲
ㅌㅙㅎ	퇳
ㅌㅚ	퇴
ㅌㅚㄱ	퇵
ㅌㅚㄲ	퇶
ㅌㅚㄳ	퇷
ㅌㅚㄴ	퇸
ㅌㅚㄵ	퇹
ㅌㅚㄶ	퇺
ㅌㅚㄷ	퇻
ㅌㅚㄹ	퇼
ㅌㅚㄺ	퇽
ㅌㅚㄻ	퇾
ㅌㅚㄼ	퇿
ㅌㅚㄽ	툀
ㅌㅚㄾ	툁
ㅌㅚㄿ	툂
ㅌㅚㅀ	툃
ㅌㅚㅁ	툄
ㅌㅚㅂ	툅
ㅌㅚㅄ	툆
ㅌㅚㅅ	툇
ㅌㅚㅆ	툈
ㅌㅚㅇ	툉
ㅌㅚㅈ	툊
ㅌㅚㅊ	툋
ㅌㅚㅋ	툌
ㅌㅚㅌ	툍
ㅌㅚㅍ	툎
ㅌㅚㅎ	툏
ㅌㅛ	툐
ㅌㅛㄱ	툑
ㅌㅛㄲ	툒
ㅌㅛㄳ	툓
ㅌㅛㄴ	툔
ㅌㅛㄵ	툕
ㅌㅛㄶ	툖
ㅌㅛㄷ	툗
ㅌㅛㄹ	툘
ㅌㅛㄺ	툙
ㅌㅛㄻ	툚
ㅌㅛㄼ	툛
ㅌㅛㄽ	툜
ㅌㅛㄾ	툝
ㅌㅛㄿ	툞
ㅌㅛㅀ	툟
ㅌㅛㅁ	툠
ㅌㅛㅂ	툡
ㅌㅛㅄ	툢
ㅌㅛㅅ	툣
ㅌㅛㅆ	툤
ㅌㅛㅇ	툥
ㅌㅛㅈ	툦
ㅌㅛㅊ	툧
ㅌㅛㅋ	툨
ㅌㅛㅌ	툩
ㅌㅛㅍ	툪
ㅌㅛㅎ	툫
ㅌㅜ	투
ㅌㅜㄱ	툭
ㅌㅜㄲ	툮
ㅌㅜㄳ	툯
ㅌㅜㄴ	툰
ㅌㅜㄵ	툱
ㅌㅜㄶ	툲
ㅌㅜㄷ	툳
ㅌㅜㄹ	툴
ㅌㅜㄺ	툵
ㅌㅜㄻ	툶
ㅌㅜㄼ	툷
ㅌㅜㄽ	툸
ㅌㅜㄾ	툹
ㅌㅜㄿ	툺
ㅌㅜㅀ	툻
ㅌㅜㅁ	툼
ㅌㅜㅂ	툽
ㅌㅜㅄ	툾
ㅌㅜㅅ	툿
ㅌㅜㅆ	퉀
ㅌㅜㅇ	퉁
ㅌㅜㅈ	퉂
ㅌㅜㅊ	퉃
ㅌㅜㅋ	퉄
ㅌㅜㅌ	퉅
ㅌㅜㅍ	퉆
ㅌㅜㅎ	퉇
ㅌㅝ	퉈
ㅌㅝㄱ	퉉
ㅌㅝㄲ	퉊
ㅌㅝㄳ	퉋
ㅌㅝㄴ	퉌
ㅌㅝㄵ	퉍
ㅌㅝㄶ	퉎
ㅌㅝㄷ	퉏
ㅌㅝㄹ	퉐
ㅌㅝㄺ	퉑
ㅌㅝㄻ	퉒
ㅌㅝㄼ	퉓
ㅌㅝㄽ	퉔
ㅌㅝㄾ	퉕
ㅌㅝㄿ	퉖
ㅌㅝㅀ	퉗
ㅌㅝㅁ	퉘
ㅌㅝㅂ	퉙
ㅌㅝㅄ	퉚
ㅌㅝㅅ	퉛
ㅌㅝㅆ	퉜
ㅌㅝㅇ	퉝
ㅌㅝㅈ	퉞
ㅌㅝㅊ	퉟
ㅌㅝㅋ	퉠
ㅌㅝㅌ	퉡
ㅌㅝㅍ	퉢
ㅌㅝㅎ	퉣
ㅌㅞ	퉤
ㅌㅞㄱ	퉥
ㅌㅞㄲ	퉦
ㅌㅞㄳ	퉧
ㅌㅞㄴ	퉨
ㅌㅞㄵ	퉩
ㅌㅞㄶ	퉪
ㅌㅞㄷ	퉫
ㅌㅞㄹ	퉬
ㅌㅞㄺ	퉭
ㅌㅞㄻ	퉮
ㅌㅞㄼ	퉯
ㅌㅞㄽ	퉰
ㅌㅞㄾ	퉱
ㅌㅞㄿ	퉲
ㅌㅞㅀ	퉳
ㅌㅞㅁ	퉴
ㅌㅞㅂ	퉵
ㅌㅞㅄ	퉶
ㅌㅞㅅ	퉷
ㅌㅞㅆ	퉸
ㅌㅞㅇ	퉹
ㅌㅞㅈ	퉺
ㅌㅞㅊ	퉻
ㅌㅞㅋ	퉼
ㅌㅞㅌ	퉽
ㅌㅞㅍ	퉾
ㅌㅞㅎ	퉿
ㅌㅟ	튀
ㅌㅟㄱ	튁
ㅌㅟㄲ	튂
ㅌㅟㄳ	튃
ㅌㅟㄴ	튄
ㅌㅟㄵ	튅
ㅌㅟㄶ	튆
ㅌㅟㄷ	튇
ㅌㅟㄹ	튈
ㅌㅟㄺ	튉
ㅌㅟㄻ	튊
ㅌㅟㄼ	튋
ㅌㅟㄽ	튌
ㅌㅟㄾ	튍
ㅌㅟㄿ	튎
ㅌㅟㅀ	튏
ㅌㅟㅁ	튐
ㅌㅟㅂ	튑
ㅌㅟㅄ	튒
ㅌㅟㅅ	튓
ㅌㅟㅆ	튔
ㅌㅟㅇ	튕
ㅌㅟㅈ	튖
ㅌㅟㅊ	튗
ㅌㅟㅋ	튘
ㅌㅟㅌ	튙
ㅌㅟㅍ	튚
ㅌㅟㅎ	튛
ㅌㅠ	튜
ㅌㅠㄱ	튝
ㅌㅠㄲ	튞
ㅌㅠㄳ	튟
ㅌㅠㄴ	튠
ㅌㅠㄵ	튡
ㅌㅠㄶ	튢
ㅌㅠㄷ	튣
ㅌㅠㄹ	튤
ㅌㅠㄺ	튥
ㅌㅠㄻ	튦
ㅌㅠㄼ	튧
ㅌㅠㄽ	튨
ㅌㅠㄾ	튩
ㅌㅠㄿ	튪
ㅌㅠㅀ	튫
ㅌㅠㅁ	튬
ㅌㅠㅂ	튭
ㅌㅠㅄ	튮
ㅌㅠㅅ	튯
ㅌㅠㅆ	튰
ㅌㅠㅇ	튱
ㅌㅠㅈ	튲
ㅌㅠㅊ	튳
ㅌㅠㅋ	튴
ㅌㅠㅌ	튵
ㅌㅠㅍ	튶
ㅌㅠㅎ	튷
ㅌㅡ	트
ㅌㅡㄱ	특
ㅌㅡㄲ	튺
ㅌㅡㄳ	튻
ㅌㅡㄴ	튼
ㅌㅡㄵ	튽
ㅌㅡㄶ	튾
ㅌㅡㄷ	튿
ㅌㅡㄹ	틀
ㅌㅡㄺ	틁
ㅌㅡㄻ	틂
ㅌㅡㄼ	틃
ㅌㅡㄽ	틄
ㅌㅡㄾ	틅
ㅌㅡㄿ	틆
ㅌㅡㅀ	틇
ㅌㅡㅁ	틈
ㅌㅡㅂ	틉
ㅌㅡㅄ	틊
ㅌㅡㅅ	틋
ㅌㅡㅆ	틌
ㅌㅡㅇ	틍
ㅌㅡㅈ	틎
ㅌㅡㅊ	틏
ㅌㅡㅋ	틐
ㅌㅡㅌ	틑
ㅌㅡㅍ	틒
ㅌㅡㅎ	틓
ㅌㅢ	틔
ㅌㅢㄱ	틕
ㅌㅢㄲ	틖
ㅌㅢㄳ	틗
ㅌㅢㄴ	틘
ㅌㅢㄵ	틙
ㅌㅢㄶ	틚
ㅌㅢㄷ	틛
ㅌㅢㄹ	틜
ㅌㅢㄺ	틝
ㅌㅢㄻ	틞
ㅌㅢㄼ	틟
ㅌㅢㄽ	틠
ㅌㅢㄾ	틡
ㅌㅢㄿ	틢
ㅌㅢㅀ	틣
ㅌㅢㅁ	틤
ㅌㅢㅂ	틥
ㅌㅢㅄ	틦
ㅌㅢㅅ	틧
ㅌㅢㅆ	틨
ㅌㅢㅇ	틩
ㅌㅢㅈ	틪
ㅌㅢㅊ	틫
ㅌㅢㅋ	틬
ㅌㅢㅌ	틭
ㅌㅢㅍ	틮
ㅌㅢㅎ	틯
ㅌㅣ	티
ㅌㅣㄱ	틱
ㅌㅣㄲ	틲
ㅌㅣㄳ	틳
ㅌㅣㄴ	틴
ㅌㅣㄵ	틵
ㅌㅣㄶ	틶
ㅌㅣㄷ	틷
ㅌㅣㄹ	틸
ㅌㅣㄺ	틹
ㅌㅣㄻ	틺
ㅌㅣㄼ	틻
ㅌㅣㄽ	틼
ㅌㅣㄾ	틽
ㅌㅣㄿ	틾
ㅌㅣㅀ	틿
ㅌㅣㅁ	팀
ㅌㅣㅂ	팁
ㅌㅣㅄ	팂
ㅌㅣㅅ	팃
ㅌㅣㅆ	팄
ㅌㅣㅇ	팅
ㅌㅣㅈ	팆
ㅌㅣㅊ	팇
ㅌㅣㅋ	팈
ㅌㅣㅌ	팉
ㅌㅣㅍ	팊
ㅌㅣㅎ	팋
ㅍㅏ	파
ㅍㅏㄱ	팍
ㅍㅏㄲ	팎
ㅍㅏㄳ	팏
ㅍㅏㄴ	판
ㅍㅏㄵ	팑
ㅍㅏㄶ	팒
ㅍㅏㄷ	팓
ㅍㅏㄹ	팔
ㅍㅏㄺ	팕
ㅍㅏㄻ	팖
ㅍㅏㄼ	팗
ㅍㅏㄽ	팘
ㅍㅏㄾ	팙
ㅍㅏㄿ	팚
ㅍㅏㅀ	팛
ㅍㅏㅁ	팜
ㅍㅏㅂ	팝
ㅍㅏㅄ	팞
ㅍㅏㅅ	팟
ㅍㅏㅆ	팠
ㅍㅏㅇ	팡
ㅍㅏㅈ	팢
ㅍㅏㅊ	팣
ㅍㅏㅋ	팤
ㅍㅏㅌ	팥
ㅍㅏㅍ	팦
ㅍㅏㅎ	팧
ㅍㅐ	패
ㅍㅐㄱ	팩
ㅍㅐㄲ	팪
ㅍㅐㄳ	팫
ㅍㅐㄴ	팬
ㅍㅐㄵ	팭
ㅍㅐㄶ	팮
ㅍㅐㄷ	팯
ㅍㅐㄹ	팰
ㅍㅐㄺ	팱
ㅍㅐㄻ	팲
ㅍㅐㄼ	팳
ㅍㅐㄽ	팴
ㅍㅐㄾ	팵
ㅍㅐㄿ	팶
ㅍㅐㅀ	팷
ㅍㅐㅁ	팸
ㅍㅐㅂ	팹
ㅍㅐㅄ	팺
ㅍㅐㅅ	팻
ㅍㅐㅆ	팼
ㅍㅐㅇ	팽
ㅍㅐㅈ	팾
ㅍㅐㅊ	팿
ㅍㅐㅋ	퍀
ㅍㅐㅌ	퍁
ㅍㅐㅍ	퍂
ㅍㅐㅎ	퍃
ㅍㅑ	퍄
ㅍㅑㄱ	퍅
ㅍㅑㄲ	퍆
ㅍㅑㄳ	퍇
ㅍㅑㄴ	퍈
ㅍㅑㄵ	퍉
ㅍㅑㄶ	퍊
ㅍㅑㄷ	퍋
ㅍㅑㄹ	퍌
ㅍㅑㄺ	퍍
ㅍㅑㄻ	퍎
ㅍㅑㄼ	퍏
ㅍㅑㄽ	퍐
ㅍㅑㄾ	퍑
ㅍㅑㄿ	퍒
ㅍㅑㅀ	퍓
ㅍㅑㅁ	퍔
ㅍㅑㅂ	퍕
ㅍㅑㅄ	퍖
ㅍㅑㅅ	퍗
ㅍㅑㅆ	퍘
ㅍㅑㅇ	퍙
ㅍㅑㅈ	퍚
ㅍㅑㅊ	퍛
ㅍㅑㅋ	퍜
ㅍㅑㅌ	퍝
ㅍㅑㅍ	퍞
ㅍㅑㅎ	퍟
ㅍㅒ	퍠
ㅍㅒㄱ	퍡
ㅍㅒㄲ	퍢
ㅍㅒㄳ	퍣
ㅍㅒㄴ	퍤
ㅍㅒㄵ	퍥
ㅍㅒㄶ	퍦
ㅍㅒㄷ	퍧
ㅍㅒㄹ	퍨
ㅍㅒㄺ	퍩
ㅍㅒㄻ	퍪
ㅍㅒㄼ	퍫
ㅍㅒㄽ	퍬
ㅍㅒㄾ	퍭
ㅍㅒㄿ	퍮
ㅍㅒㅀ	퍯
ㅍㅒㅁ	퍰
ㅍㅒㅂ	퍱
ㅍㅒㅄ	퍲
ㅍㅒㅅ	퍳
ㅍㅒㅆ	퍴
ㅍㅒㅇ	퍵
ㅍㅒㅈ	퍶
ㅍㅒㅊ	퍷
ㅍㅒㅋ	퍸
ㅍㅒㅌ	퍹
ㅍㅒㅍ	퍺
ㅍㅒㅎ	퍻
ㅍㅓ	퍼
ㅍㅓㄱ	퍽
ㅍㅓㄲ	퍾
ㅍㅓㄳ	퍿
ㅍㅓㄴ	펀
ㅍㅓㄵ	펁
ㅍㅓㄶ	펂
ㅍㅓㄷ	펃
ㅍㅓㄹ	펄
ㅍㅓㄺ	펅
ㅍㅓㄻ	펆
ㅍㅓㄼ	펇
ㅍㅓㄽ	펈
ㅍㅓㄾ	펉
ㅍㅓㄿ	펊
ㅍㅓㅀ	펋
ㅍㅓㅁ	펌
ㅍㅓㅂ	펍
ㅍㅓㅄ	펎
ㅍㅓㅅ	펏
ㅍㅓㅆ	펐
ㅍㅓㅇ	펑
ㅍㅓㅈ	펒
ㅍㅓㅊ	펓
ㅍㅓㅋ	펔
ㅍㅓㅌ	펕
ㅍㅓㅍ	펖
ㅍㅓㅎ	펗
ㅍㅔ	페
ㅍㅔㄱ	펙
ㅍㅔㄲ	펚
ㅍㅔㄳ	펛
ㅍㅔㄴ	펜
ㅍㅔㄵ	펝
ㅍㅔㄶ	펞
ㅍㅔㄷ	펟
ㅍㅔㄹ	펠
ㅍㅔㄺ	펡
ㅍㅔㄻ	펢
ㅍㅔㄼ	펣
ㅍㅔㄽ	펤
ㅍㅔㄾ	펥
ㅍㅔㄿ	펦
ㅍㅔㅀ	펧
ㅍㅔㅁ	펨
ㅍㅔㅂ	펩
ㅍㅔㅄ	펪
ㅍㅔㅅ	펫
ㅍㅔㅆ	펬
ㅍㅔㅇ	펭
ㅍㅔㅈ	펮
ㅍㅔㅊ	펯
ㅍㅔㅋ	펰
ㅍㅔㅌ	펱
ㅍㅔㅍ	펲
ㅍㅔㅎ	펳
ㅍㅕ	펴
ㅍㅕㄱ	펵
ㅍㅕㄲ	펶
ㅍㅕㄳ	펷
ㅍㅕㄴ	편
ㅍㅕㄵ	펹
ㅍㅕㄶ	펺
ㅍㅕㄷ	펻
ㅍㅕㄹ	펼
ㅍㅕㄺ	펽
ㅍㅕㄻ	펾
ㅍㅕㄼ	펿
ㅍㅕㄽ	폀
ㅍㅕㄾ	폁
ㅍㅕㄿ	폂
ㅍㅕㅀ	폃
ㅍㅕㅁ	폄
ㅍㅕㅂ	폅
ㅍㅕㅄ	폆
ㅍㅕㅅ	폇
ㅍㅕㅆ	폈
ㅍㅕㅇ	평
ㅍㅕㅈ	폊
ㅍㅕㅊ	폋
ㅍㅕㅋ	폌
ㅍㅕㅌ	폍
ㅍㅕㅍ	폎
ㅍㅕㅎ	폏
ㅍㅖ	폐
ㅍㅖㄱ	폑
ㅍㅖㄲ	폒
ㅍㅖㄳ	폓
ㅍㅖㄴ	폔
ㅍㅖㄵ	폕
ㅍㅖㄶ	폖
ㅍㅖㄷ	폗
ㅍㅖㄹ	폘
ㅍㅖㄺ	폙
ㅍㅖㄻ	폚
ㅍㅖㄼ	폛
ㅍㅖㄽ	폜
ㅍㅖㄾ	폝
ㅍㅖㄿ	폞
ㅍㅖㅀ	폟
ㅍㅖㅁ	폠
ㅍㅖㅂ	폡
ㅍㅖㅄ	폢
ㅍㅖㅅ	폣
ㅍㅖㅆ	폤
ㅍㅖㅇ	폥
ㅍㅖㅈ	폦
ㅍㅖㅊ	폧
ㅍㅖㅋ	폨
ㅍㅖㅌ	폩
ㅍㅖㅍ	폪
ㅍㅖㅎ	폫
ㅍㅗ	포
ㅍㅗㄱ	폭
ㅍㅗㄲ	폮
ㅍㅗㄳ	폯
ㅍㅗㄴ	폰
ㅍㅗㄵ	폱
ㅍㅗㄶ	폲
ㅍㅗㄷ	폳
ㅍㅗㄹ	폴
ㅍㅗㄺ	폵
ㅍㅗㄻ	폶
ㅍㅗㄼ	폷
ㅍㅗㄽ	폸
ㅍㅗㄾ	폹
ㅍㅗㄿ	폺
ㅍㅗㅀ	폻
ㅍㅗㅁ	폼
ㅍㅗㅂ	폽
ㅍㅗㅄ	폾
ㅍㅗㅅ	폿
ㅍㅗㅆ	퐀
ㅍㅗㅇ	퐁
ㅍㅗㅈ	퐂
ㅍㅗㅊ	퐃
ㅍㅗㅋ	퐄
ㅍㅗㅌ	퐅
ㅍㅗㅍ	퐆
ㅍㅗㅎ	퐇
ㅍㅘ	퐈
ㅍㅘㄱ	퐉
ㅍㅘㄲ	퐊
ㅍㅘㄳ	퐋
ㅍㅘㄴ	퐌
ㅍㅘㄵ	퐍
ㅍㅘㄶ	퐎
ㅍㅘㄷ	퐏
ㅍㅘㄹ	퐐
ㅍㅘㄺ	퐑
ㅍㅘㄻ	퐒
ㅍㅘㄼ	퐓
ㅍㅘㄽ	퐔
ㅍㅘㄾ	퐕
ㅍㅘㄿ	퐖
ㅍㅘㅀ	퐗
ㅍㅘㅁ	퐘
ㅍㅘㅂ	퐙
ㅍㅘㅄ	퐚
ㅍㅘㅅ	퐛
ㅍㅘㅆ	퐜
ㅍㅘㅇ	퐝
ㅍㅘㅈ	퐞
ㅍㅘㅊ	퐟
ㅍㅘㅋ	퐠
ㅍㅘㅌ	퐡
ㅍㅘㅍ	퐢
ㅍㅘㅎ	퐣
ㅍㅙ	퐤
ㅍㅙㄱ	퐥
ㅍㅙㄲ	퐦
ㅍㅙㄳ	퐧
ㅍㅙㄴ	퐨
ㅍㅙㄵ	퐩
ㅍㅙㄶ	퐪
ㅍㅙㄷ	퐫
ㅍㅙㄹ	퐬
ㅍㅙㄺ	퐭
ㅍㅙㄻ	퐮
ㅍㅙㄼ	퐯
ㅍㅙㄽ	퐰
ㅍㅙㄾ	퐱
ㅍㅙㄿ	퐲
ㅍㅙㅀ	퐳
ㅍㅙㅁ	퐴
ㅍㅙㅂ	퐵
ㅍㅙㅄ	퐶
ㅍㅙㅅ	퐷
ㅍㅙㅆ	퐸
ㅍㅙㅇ	퐹
ㅍㅙㅈ	퐺
ㅍㅙㅊ	퐻
ㅍㅙㅋ	퐼
ㅍㅙㅌ	퐽
ㅍㅙㅍ	퐾
ㅍㅙㅎ	퐿
ㅍㅚ	푀
ㅍㅚㄱ	푁
ㅍㅚㄲ	푂
ㅍㅚㄳ	푃
ㅍㅚㄴ	푄
ㅍㅚㄵ	푅
ㅍㅚㄶ	푆
ㅍㅚㄷ	푇
ㅍㅚㄹ	푈
ㅍㅚㄺ	푉
ㅍㅚㄻ	푊
ㅍㅚㄼ	푋
ㅍㅚㄽ	푌
ㅍㅚㄾ	푍
ㅍㅚㄿ	푎
ㅍㅚㅀ	푏
ㅍㅚㅁ	푐
ㅍㅚㅂ	푑
ㅍㅚㅄ	푒
ㅍㅚㅅ	푓
ㅍㅚㅆ	푔
ㅍㅚㅇ	푕
ㅍㅚㅈ	푖
ㅍㅚㅊ	푗
ㅍㅚㅋ	푘
ㅍㅚㅌ	푙
ㅍㅚㅍ	푚
ㅍㅚㅎ	푛
ㅍㅛ	표
ㅍㅛㄱ	푝
ㅍㅛㄲ	푞
ㅍㅛㄳ	푟
ㅍㅛㄴ	푠
ㅍㅛㄵ	푡
ㅍㅛㄶ	푢
ㅍㅛㄷ	푣
ㅍㅛㄹ	푤
ㅍㅛㄺ	푥
ㅍㅛㄻ	푦
ㅍㅛㄼ	푧
ㅍㅛㄽ	푨
ㅍㅛㄾ	푩
ㅍㅛㄿ	푪
ㅍㅛㅀ	푫
ㅍㅛㅁ	푬
ㅍㅛㅂ	푭
ㅍㅛㅄ	푮
ㅍㅛㅅ	푯
ㅍㅛㅆ	푰
ㅍㅛㅇ	푱
ㅍㅛㅈ	푲
ㅍㅛㅊ	푳
ㅍㅛㅋ	푴
ㅍㅛㅌ	푵
ㅍㅛㅍ	푶
ㅍㅛㅎ	푷
ㅍㅜ	푸
ㅍㅜㄱ	푹
ㅍㅜㄲ	푺
ㅍㅜㄳ	푻
ㅍㅜㄴ	푼
ㅍㅜㄵ	푽
ㅍㅜㄶ	푾
ㅍㅜㄷ	푿
ㅍㅜㄹ	풀
ㅍㅜㄺ	풁
ㅍㅜㄻ	풂
ㅍㅜㄼ	풃
ㅍㅜㄽ	풄
ㅍㅜㄾ	풅
ㅍㅜㄿ	풆
ㅍㅜㅀ	풇
ㅍㅜㅁ	품
ㅍㅜㅂ	풉
ㅍㅜㅄ	풊
ㅍㅜㅅ	풋
ㅍㅜㅆ	풌
ㅍㅜㅇ	풍
ㅍㅜㅈ	풎
ㅍㅜㅊ	풏
ㅍㅜㅋ	풐
ㅍㅜㅌ	풑
ㅍㅜㅍ	풒
ㅍㅜㅎ	풓
ㅍㅝ	풔
ㅍㅝㄱ	풕
ㅍㅝㄲ	풖
ㅍㅝㄳ	풗
ㅍㅝㄴ	풘
ㅍㅝㄵ	풙
ㅍㅝㄶ	풚
ㅍㅝㄷ	풛
ㅍㅝㄹ	풜
ㅍㅝㄺ	풝
ㅍㅝㄻ	풞
ㅍㅝㄼ	풟
ㅍㅝㄽ	풠
ㅍㅝㄾ	풡
ㅍㅝㄿ	풢
ㅍㅝㅀ	풣
ㅍㅝㅁ	풤
ㅍㅝㅂ	풥
ㅍㅝㅄ	풦
ㅍㅝㅅ	풧
ㅍㅝㅆ	풨
ㅍㅝㅇ	풩
ㅍㅝㅈ	풪
ㅍㅝㅊ	풫
ㅍㅝㅋ	풬
ㅍㅝㅌ	풭
ㅍㅝㅍ	풮
ㅍㅝㅎ	풯
ㅍㅞ	풰
ㅍㅞㄱ	풱
ㅍㅞㄲ	풲
ㅍㅞㄳ	풳
ㅍㅞㄴ	풴
ㅍㅞㄵ	풵
ㅍㅞㄶ	풶
ㅍㅞㄷ	풷
ㅍㅞㄹ	풸
ㅍㅞㄺ	풹
ㅍㅞㄻ	풺
ㅍㅞㄼ	풻
ㅍㅞㄽ	풼
ㅍㅞㄾ	풽
ㅍㅞㄿ	풾
ㅍㅞㅀ	풿
ㅍㅞㅁ	퓀
ㅍㅞㅂ	퓁
ㅍㅞㅄ	퓂
ㅍㅞㅅ	퓃
ㅍㅞㅆ	퓄
ㅍㅞㅇ	퓅
ㅍㅞㅈ	퓆
ㅍㅞㅊ	퓇
ㅍㅞㅋ	퓈
ㅍㅞㅌ	퓉
ㅍㅞㅍ	퓊
ㅍㅞㅎ	퓋
ㅍㅟ	퓌
ㅍㅟㄱ	퓍
ㅍㅟㄲ	퓎
ㅍㅟㄳ	퓏
ㅍㅟㄴ	퓐
ㅍㅟㄵ	퓑
ㅍㅟㄶ	퓒
ㅍㅟㄷ	퓓
ㅍㅟㄹ	퓔
ㅍㅟㄺ	퓕
ㅍㅟㄻ	퓖
ㅍㅟㄼ	퓗
ㅍㅟㄽ	퓘
ㅍㅟㄾ	퓙
ㅍㅟㄿ	퓚
ㅍㅟㅀ	퓛
ㅍㅟㅁ	퓜
ㅍㅟㅂ	퓝
ㅍㅟㅄ	퓞
ㅍㅟㅅ	퓟
ㅍㅟㅆ	퓠
ㅍㅟㅇ	퓡
ㅍㅟㅈ	퓢
ㅍㅟㅊ	퓣
ㅍㅟㅋ	퓤
ㅍㅟㅌ	퓥
ㅍㅟㅍ	퓦
ㅍㅟㅎ	퓧
ㅍㅠ	퓨
ㅍㅠㄱ	퓩
ㅍㅠㄲ	퓪
ㅍㅠㄳ	퓫
ㅍㅠㄴ	퓬
ㅍㅠㄵ	퓭
ㅍㅠㄶ	퓮
ㅍㅠㄷ	퓯
ㅍㅠㄹ	퓰
ㅍㅠㄺ	퓱
ㅍㅠㄻ	퓲
ㅍㅠㄼ	퓳
ㅍㅠㄽ	퓴
ㅍㅠㄾ	퓵
ㅍㅠㄿ	퓶
ㅍㅠㅀ	퓷
ㅍㅠㅁ	퓸
ㅍㅠㅂ	퓹
ㅍㅠㅄ	퓺
ㅍㅠㅅ	퓻
ㅍㅠㅆ	퓼
ㅍㅠㅇ	퓽
ㅍㅠㅈ	퓾
ㅍㅠㅊ	퓿
ㅍㅠㅋ	픀
ㅍㅠㅌ	픁
ㅍㅠㅍ	픂
ㅍㅠㅎ	픃
ㅍㅡ	프
ㅍㅡㄱ	픅
ㅍㅡㄲ	픆
ㅍㅡㄳ	픇
ㅍㅡㄴ	픈
ㅍㅡㄵ	픉
ㅍㅡㄶ	픊
ㅍㅡㄷ	픋
ㅍㅡㄹ	플
ㅍㅡㄺ	픍
ㅍㅡㄻ	픎
ㅍㅡㄼ	픏
ㅍㅡㄽ	픐
ㅍㅡㄾ	픑
ㅍㅡㄿ	픒
ㅍㅡㅀ	픓
ㅍㅡㅁ	픔
ㅍㅡㅂ	픕
ㅍㅡㅄ	픖
ㅍㅡㅅ	픗
ㅍㅡㅆ	픘
ㅍㅡㅇ	픙
ㅍㅡㅈ	픚
ㅍㅡㅊ	픛
ㅍㅡㅋ	픜
ㅍㅡㅌ	픝
ㅍㅡㅍ	픞
ㅍㅡㅎ	픟
ㅍㅢ	픠
ㅍㅢㄱ	픡
ㅍㅢㄲ	픢
ㅍㅢㄳ	픣
ㅍㅢㄴ	픤
ㅍㅢㄵ	픥
ㅍㅢㄶ	픦
ㅍㅢㄷ	픧
ㅍㅢㄹ	픨
ㅍㅢㄺ	픩
ㅍㅢㄻ	픪
ㅍㅢㄼ	픫
ㅍㅢㄽ	픬
ㅍㅢㄾ	픭
ㅍㅢㄿ	픮
ㅍㅢㅀ	픯
ㅍㅢㅁ	픰
ㅍㅢㅂ	픱
ㅍㅢㅄ	픲
ㅍㅢㅅ	픳
ㅍㅢㅆ	픴
ㅍㅢㅇ	픵
ㅍㅢㅈ	픶
ㅍㅢㅊ	픷
ㅍㅢㅋ	픸
ㅍㅢㅌ	픹
ㅍㅢㅍ	픺
ㅍㅢㅎ	픻
ㅍㅣ	피
ㅍㅣㄱ	픽
ㅍㅣㄲ	픾
ㅍㅣㄳ	픿
ㅍㅣㄴ	핀
ㅍㅣㄵ	핁
ㅍㅣㄶ	핂
ㅍㅣㄷ	핃
ㅍㅣㄹ	필
ㅍㅣㄺ	핅
ㅍㅣㄻ	핆
ㅍㅣㄼ	핇
ㅍㅣㄽ	핈
ㅍㅣㄾ	핉
ㅍㅣㄿ	핊
ㅍㅣㅀ	핋
ㅍㅣㅁ	핌
ㅍㅣㅂ	핍
ㅍㅣㅄ	핎
ㅍㅣㅅ	핏
ㅍㅣㅆ	핐
ㅍㅣㅇ	핑
ㅍㅣㅈ	핒
ㅍㅣㅊ	핓
ㅍㅣㅋ	핔
ㅍㅣㅌ	핕
ㅍㅣㅍ	핖
ㅍㅣㅎ	핗
ㅎㅏ	하
ㅎㅏㄱ	학
ㅎㅏㄲ	핚
ㅎㅏㄳ	핛
ㅎㅏㄴ	한
ㅎㅏㄵ	핝
ㅎㅏㄶ	핞
ㅎㅏㄷ	핟
ㅎㅏㄹ	할
ㅎㅏㄺ	핡
ㅎㅏㄻ	핢
ㅎㅏㄼ	핣
ㅎㅏㄽ	핤
ㅎㅏㄾ	핥
ㅎㅏㄿ	핦
ㅎㅏㅀ	핧
ㅎㅏㅁ	함
ㅎㅏㅂ	합
ㅎㅏㅄ	핪
ㅎㅏㅅ	핫
ㅎㅏㅆ	핬
ㅎㅏㅇ	항
ㅎㅏㅈ	핮
ㅎㅏㅊ	핯
ㅎㅏㅋ	핰
ㅎㅏㅌ	핱
ㅎㅏㅍ	핲
ㅎㅏㅎ	핳
ㅎㅐ	해
ㅎㅐㄱ	핵
ㅎㅐㄲ	핶
ㅎㅐㄳ	핷
ㅎㅐㄴ	핸
ㅎㅐㄵ	핹
ㅎㅐㄶ	핺
ㅎㅐㄷ	핻
ㅎㅐㄹ	핼
ㅎㅐㄺ	핽
ㅎㅐㄻ	핾
ㅎㅐㄼ	핿
ㅎㅐㄽ	햀
ㅎㅐㄾ	햁
ㅎㅐㄿ	햂
ㅎㅐㅀ	햃
ㅎㅐㅁ	햄
ㅎㅐㅂ	햅
ㅎㅐㅄ	햆
ㅎㅐㅅ	햇
ㅎㅐㅆ	했
ㅎㅐㅇ	행
ㅎㅐㅈ	햊
ㅎㅐㅊ	햋
ㅎㅐㅋ	햌
ㅎㅐㅌ	햍
ㅎㅐㅍ	햎
ㅎㅐㅎ	햏
ㅎㅑ	햐
ㅎㅑㄱ	햑
ㅎㅑㄲ	햒
ㅎㅑㄳ	햓
ㅎㅑㄴ	햔
ㅎㅑㄵ	햕
ㅎㅑㄶ	햖
ㅎㅑㄷ	햗
ㅎㅑㄹ	햘
ㅎㅑㄺ	햙
ㅎㅑㄻ	햚
ㅎㅑㄼ	햛
ㅎㅑㄽ	햜
ㅎㅑㄾ	햝
ㅎㅑㄿ	햞
ㅎㅑㅀ	햟
ㅎㅑㅁ	햠
ㅎㅑㅂ	햡
ㅎㅑㅄ	햢
ㅎㅑㅅ	햣
ㅎㅑㅆ	햤
ㅎㅑㅇ	향
ㅎㅑㅈ	햦
ㅎㅑㅊ	햧
ㅎㅑㅋ	햨
ㅎㅑㅌ	햩
ㅎㅑㅍ	햪
ㅎㅑㅎ	햫
ㅎㅒ	햬
ㅎㅒㄱ	햭
ㅎㅒㄲ	햮
ㅎㅒㄳ	햯
ㅎㅒㄴ	햰
ㅎㅒㄵ	햱
ㅎㅒㄶ	햲
ㅎㅒㄷ	햳
ㅎㅒㄹ	햴
ㅎㅒㄺ	햵
ㅎㅒㄻ	햶
ㅎㅒㄼ	햷
ㅎㅒㄽ	햸
ㅎㅒㄾ	햹
ㅎㅒㄿ	햺
ㅎㅒㅀ	햻
ㅎㅒㅁ	햼
ㅎㅒㅂ	햽
ㅎㅒㅄ	햾
ㅎㅒㅅ	햿
ㅎㅒㅆ	헀
ㅎㅒㅇ	헁
ㅎㅒㅈ	헂
ㅎㅒㅊ	헃
ㅎㅒㅋ	헄
ㅎㅒㅌ	헅
ㅎㅒㅍ	헆
ㅎㅒㅎ	헇
ㅎㅓ	허
ㅎㅓㄱ	헉
ㅎㅓㄲ	헊
ㅎㅓㄳ	헋
ㅎㅓㄴ	헌
ㅎㅓㄵ	헍
ㅎㅓㄶ	헎
ㅎㅓㄷ	헏
ㅎㅓㄹ	헐
ㅎㅓㄺ	헑
ㅎㅓㄻ	헒
ㅎㅓㄼ	헓
ㅎㅓㄽ	헔
ㅎㅓㄾ	헕
ㅎㅓㄿ	헖
ㅎㅓㅀ	헗
ㅎㅓㅁ	험
ㅎㅓㅂ	헙
ㅎㅓㅄ	헚
ㅎㅓㅅ	헛
ㅎㅓㅆ	헜
ㅎㅓㅇ	헝
ㅎㅓㅈ	헞
ㅎㅓㅊ	헟
ㅎㅓㅋ	헠
ㅎㅓㅌ	헡
ㅎㅓㅍ	헢
ㅎㅓㅎ	헣
ㅎㅔ	헤
ㅎㅔㄱ	헥
ㅎㅔㄲ	헦
ㅎㅔㄳ	헧
ㅎㅔㄴ	헨
ㅎㅔㄵ	헩
ㅎㅔㄶ	헪
ㅎㅔㄷ	헫
ㅎㅔㄹ	헬
ㅎㅔㄺ	헭
ㅎㅔㄻ	헮
ㅎㅔㄼ	헯
ㅎㅔㄽ	헰
ㅎㅔㄾ	헱
ㅎㅔㄿ	헲
ㅎㅔㅀ	헳
ㅎㅔㅁ	헴
ㅎㅔㅂ	헵
ㅎㅔㅄ	헶
ㅎㅔㅅ	헷
ㅎㅔㅆ	헸
ㅎㅔㅇ	헹
ㅎㅔㅈ	헺
ㅎㅔㅊ	헻
ㅎㅔㅋ	헼
ㅎㅔㅌ	헽
ㅎㅔㅍ	헾
ㅎㅔㅎ	헿
ㅎㅕ	혀
ㅎㅕㄱ	혁
ㅎㅕㄲ	혂
ㅎㅕㄳ	혃
ㅎㅕㄴ	현
ㅎㅕㄵ	혅
ㅎㅕㄶ	혆
ㅎㅕㄷ	혇
ㅎㅕㄹ	혈
ㅎㅕㄺ	혉
ㅎㅕㄻ	혊
ㅎㅕㄼ	혋
ㅎㅕㄽ	혌
ㅎㅕㄾ	혍
ㅎㅕㄿ	혎
ㅎㅕㅀ	혏
ㅎㅕㅁ	혐
ㅎㅕㅂ	협
ㅎㅕㅄ	혒
ㅎㅕㅅ	혓
ㅎㅕㅆ	혔
ㅎㅕㅇ	형
ㅎㅕㅈ	혖
ㅎㅕㅊ	혗
ㅎㅕㅋ	혘
ㅎㅕㅌ	혙
ㅎㅕㅍ	혚
ㅎㅕㅎ	혛
ㅎㅖ	혜
ㅎㅖㄱ	혝
ㅎㅖㄲ	혞
ㅎㅖㄳ	혟
ㅎㅖㄴ	혠
ㅎㅖㄵ	혡
ㅎㅖㄶ	혢
ㅎㅖㄷ	혣
ㅎㅖㄹ	혤
ㅎㅖㄺ	혥
ㅎㅖㄻ	혦
ㅎㅖㄼ	혧
ㅎㅖㄽ	혨
ㅎㅖㄾ	혩
ㅎㅖㄿ	혪
ㅎㅖㅀ	혫
ㅎㅖㅁ	혬
ㅎㅖㅂ	혭
ㅎㅖㅄ	혮
ㅎㅖㅅ	혯
ㅎㅖㅆ	혰
ㅎㅖㅇ	혱
ㅎㅖㅈ	혲
ㅎㅖㅊ	혳
ㅎㅖㅋ	혴
ㅎㅖㅌ	혵
ㅎㅖㅍ	혶
ㅎㅖㅎ	혷
ㅎㅗ	호
ㅎㅗㄱ	혹
ㅎㅗㄲ	혺
ㅎㅗㄳ	혻
ㅎㅗㄴ	혼
ㅎㅗㄵ	혽
ㅎㅗㄶ	혾
ㅎㅗㄷ	혿
ㅎㅗㄹ	홀
ㅎㅗㄺ	홁
ㅎㅗㄻ	홂
ㅎㅗㄼ	홃
ㅎㅗㄽ	홄
ㅎㅗㄾ	홅
ㅎㅗㄿ	홆
ㅎㅗㅀ	홇
ㅎㅗㅁ	홈
ㅎㅗㅂ	홉
ㅎㅗㅄ	홊
ㅎㅗㅅ	홋
ㅎㅗㅆ	홌
ㅎㅗㅇ	홍
ㅎㅗㅈ	홎
ㅎㅗㅊ	홏
ㅎㅗㅋ	홐
ㅎㅗㅌ	홑
ㅎㅗㅍ	홒
ㅎㅗㅎ	홓
ㅎㅘ	화
ㅎㅘㄱ	확
ㅎㅘㄲ	홖
ㅎㅘㄳ	홗
ㅎㅘㄴ	환
ㅎㅘㄵ	홙
ㅎㅘㄶ	홚
ㅎㅘㄷ	홛
ㅎㅘㄹ	활
ㅎㅘㄺ	홝
ㅎㅘㄻ	홞
ㅎㅘㄼ	홟
ㅎㅘㄽ	홠
ㅎㅘㄾ	홡
ㅎㅘㄿ	홢
ㅎㅘㅀ	홣
ㅎㅘㅁ	홤
ㅎㅘㅂ	홥
ㅎㅘㅄ	홦
ㅎㅘㅅ	홧
ㅎㅘㅆ	홨
ㅎㅘㅇ	황
ㅎㅘㅈ	홪
ㅎㅘㅊ	홫
ㅎㅘㅋ	홬
ㅎㅘㅌ	홭
ㅎㅘㅍ	홮
ㅎㅘㅎ	홯
ㅎㅙ	홰
ㅎㅙㄱ	홱
ㅎㅙㄲ	홲
ㅎㅙㄳ	홳
ㅎㅙㄴ	홴
ㅎㅙㄵ	홵
ㅎㅙㄶ	홶
ㅎㅙㄷ	홷
ㅎㅙㄹ	홸
ㅎㅙㄺ	홹
ㅎㅙㄻ	홺
ㅎㅙㄼ	홻
ㅎㅙㄽ	홼
ㅎㅙㄾ	홽
ㅎㅙㄿ	홾
ㅎㅙㅀ	홿
ㅎㅙㅁ	횀
ㅎㅙㅂ	횁
ㅎㅙㅄ	횂
ㅎㅙㅅ	횃
ㅎㅙㅆ	횄
ㅎㅙㅇ	횅
ㅎㅙㅈ	횆
ㅎㅙㅊ	횇
ㅎㅙㅋ	횈
ㅎㅙㅌ	횉
ㅎㅙㅍ	횊
ㅎㅙㅎ	횋
ㅎㅚ	회
ㅎㅚㄱ	획
ㅎㅚㄲ	횎
ㅎㅚㄳ	횏
ㅎㅚㄴ	횐
ㅎㅚㄵ	횑
ㅎㅚㄶ	횒
ㅎㅚㄷ	횓
ㅎㅚㄹ	횔
ㅎㅚㄺ	횕
ㅎㅚㄻ	횖
ㅎㅚㄼ	횗
ㅎㅚㄽ	횘
ㅎㅚㄾ	횙
ㅎㅚㄿ	횚
ㅎㅚㅀ	횛
ㅎㅚㅁ	횜
ㅎㅚㅂ	횝
ㅎㅚㅄ	횞
ㅎㅚㅅ	횟
ㅎㅚㅆ	횠
ㅎㅚㅇ	횡
ㅎㅚㅈ	횢
ㅎㅚㅊ	횣
ㅎㅚㅋ	횤
ㅎㅚㅌ	횥
ㅎㅚㅍ	횦
ㅎㅚㅎ	횧
ㅎㅛ	효
ㅎㅛㄱ	횩
ㅎㅛㄲ	횪
ㅎㅛㄳ	횫
ㅎㅛㄴ	횬
ㅎㅛㄵ	횭
ㅎㅛㄶ	횮
ㅎㅛㄷ	횯
ㅎㅛㄹ	횰
ㅎㅛㄺ	횱
ㅎㅛㄻ	횲
ㅎㅛㄼ	횳
ㅎㅛㄽ	횴
ㅎㅛㄾ	횵
ㅎㅛㄿ	횶
ㅎㅛㅀ	횷
ㅎㅛㅁ	횸
ㅎㅛㅂ	횹
ㅎㅛㅄ	횺
ㅎㅛㅅ	횻
ㅎㅛㅆ	횼
ㅎㅛㅇ	횽
ㅎㅛㅈ	횾
ㅎㅛㅊ	횿
ㅎㅛㅋ	훀
ㅎㅛㅌ	훁
ㅎㅛㅍ	훂
ㅎㅛㅎ	훃
ㅎㅜ	후
ㅎㅜㄱ	훅
ㅎㅜㄲ	훆
ㅎㅜㄳ	훇
ㅎㅜㄴ	훈
ㅎㅜㄵ	훉
ㅎㅜㄶ	훊
ㅎㅜㄷ	훋
ㅎㅜㄹ	훌
ㅎㅜㄺ	훍
ㅎㅜㄻ	훎
ㅎㅜㄼ	훏
ㅎㅜㄽ	훐
ㅎㅜㄾ	훑
ㅎㅜㄿ	훒
ㅎㅜㅀ	훓
ㅎㅜㅁ	훔
ㅎㅜㅂ	훕
ㅎㅜㅄ	훖
ㅎㅜㅅ	훗
ㅎㅜㅆ	훘
ㅎㅜㅇ	훙
ㅎㅜㅈ	훚
ㅎㅜㅊ	훛
ㅎㅜㅋ	훜
ㅎㅜㅌ	훝
ㅎㅜㅍ	훞
ㅎㅜㅎ	훟
ㅎㅝ	훠
ㅎㅝㄱ	훡
ㅎㅝㄲ	훢
ㅎㅝㄳ	훣
ㅎㅝㄴ	훤
ㅎㅝㄵ	훥
ㅎㅝㄶ	훦
ㅎㅝㄷ	훧
ㅎㅝㄹ	훨
ㅎㅝㄺ	훩
ㅎㅝㄻ	훪
ㅎㅝㄼ	훫
ㅎㅝㄽ	훬
ㅎㅝㄾ	훭
ㅎㅝㄿ	훮
ㅎㅝㅀ	훯
ㅎㅝㅁ	훰
ㅎㅝㅂ	훱
ㅎㅝㅄ	훲
ㅎㅝㅅ	훳
ㅎㅝㅆ	훴
ㅎㅝㅇ	훵
ㅎㅝㅈ	훶
ㅎㅝㅊ	훷
ㅎㅝㅋ	훸
ㅎㅝㅌ	훹
ㅎㅝㅍ	훺
ㅎㅝㅎ	훻
ㅎㅞ	훼
ㅎㅞㄱ	훽
ㅎㅞㄲ	훾
ㅎㅞㄳ	훿
ㅎㅞㄴ	휀
ㅎㅞㄵ	휁
ㅎㅞㄶ	휂
ㅎㅞㄷ	휃
ㅎㅞㄹ	휄
ㅎㅞㄺ	휅
ㅎㅞㄻ	휆
ㅎㅞㄼ	휇
ㅎㅞㄽ	휈
ㅎㅞㄾ	휉
ㅎㅞㄿ	휊
ㅎㅞㅀ	휋
ㅎㅞㅁ	휌
ㅎㅞㅂ	휍
ㅎㅞㅄ	휎
ㅎㅞㅅ	휏
ㅎㅞㅆ	휐
ㅎㅞㅇ	휑
ㅎㅞㅈ	휒
ㅎㅞㅊ	휓
ㅎㅞㅋ	휔
ㅎㅞㅌ	휕
ㅎㅞㅍ	휖
ㅎㅞㅎ	휗
ㅎㅟ	휘
ㅎㅟㄱ	휙
ㅎㅟㄲ	휚
ㅎㅟㄳ	휛
ㅎㅟㄴ	휜
ㅎㅟㄵ	휝
ㅎㅟㄶ	휞
ㅎㅟㄷ	휟
ㅎㅟㄹ	휠
ㅎㅟㄺ	휡
ㅎㅟㄻ	휢
ㅎㅟㄼ	휣
ㅎㅟㄽ	휤
ㅎㅟㄾ	휥
ㅎㅟㄿ	휦
ㅎㅟㅀ	휧
ㅎㅟㅁ	휨
ㅎㅟㅂ	휩
ㅎㅟㅄ	휪
ㅎㅟㅅ	휫
ㅎㅟㅆ	휬
ㅎㅟㅇ	휭
ㅎㅟㅈ	휮
ㅎㅟㅊ	휯
ㅎㅟㅋ	휰
ㅎㅟㅌ	휱
ㅎㅟㅍ	휲
ㅎㅟㅎ	휳
ㅎㅠ	휴
ㅎㅠㄱ	휵
ㅎㅠㄲ	휶
ㅎㅠㄳ	휷
ㅎㅠㄴ	휸
ㅎㅠㄵ	휹
ㅎㅠㄶ	휺
ㅎㅠㄷ	휻
ㅎㅠㄹ	휼
ㅎㅠㄺ	휽
ㅎㅠㄻ	휾
ㅎㅠㄼ	휿
ㅎㅠㄽ	흀
ㅎㅠㄾ	흁
ㅎㅠㄿ	흂
ㅎㅠㅀ	흃
ㅎㅠㅁ	흄
ㅎㅠㅂ	흅
ㅎㅠㅄ	흆
ㅎㅠㅅ	흇
ㅎㅠㅆ	흈
ㅎㅠㅇ	흉
ㅎㅠㅈ	흊
ㅎㅠㅊ	흋
ㅎㅠㅋ	흌
ㅎㅠㅌ	흍
ㅎㅠㅍ	흎
ㅎㅠㅎ	흏
ㅎㅡ	흐
ㅎㅡㄱ	흑
ㅎㅡㄲ	흒
ㅎㅡㄳ	흓
ㅎㅡㄴ	흔
ㅎㅡㄵ	흕
ㅎㅡㄶ	흖
ㅎㅡㄷ	흗
ㅎㅡㄹ	흘
ㅎㅡㄺ	흙
ㅎㅡㄻ	흚
ㅎㅡㄼ	흛
ㅎㅡㄽ	흜
ㅎㅡㄾ	흝
ㅎㅡㄿ	흞
ㅎㅡㅀ	흟
ㅎㅡㅁ	흠
ㅎㅡㅂ	흡
ㅎㅡㅄ	흢
ㅎㅡㅅ	흣
ㅎㅡㅆ	흤
ㅎㅡㅇ	흥
ㅎㅡㅈ	흦
ㅎㅡㅊ	흧
ㅎㅡㅋ	흨
ㅎㅡㅌ	흩
ㅎㅡㅍ	흪
ㅎㅡㅎ	흫
ㅎㅢ	희
ㅎㅢㄱ	흭
ㅎㅢㄲ	흮
ㅎㅢㄳ	흯
ㅎㅢㄴ	흰
ㅎㅢㄵ	흱
ㅎㅢㄶ	흲
ㅎㅢㄷ	흳
ㅎㅢㄹ	흴
ㅎㅢㄺ	흵
ㅎㅢㄻ	흶
ㅎㅢㄼ	흷
ㅎㅢㄽ	흸
ㅎㅢㄾ	흹
ㅎㅢㄿ	흺
ㅎㅢㅀ	흻
ㅎㅢㅁ	흼
ㅎㅢㅂ	흽
ㅎㅢㅄ	흾
ㅎㅢㅅ	흿
ㅎㅢㅆ	힀
ㅎㅢㅇ	힁
ㅎㅢㅈ	힂
ㅎㅢㅊ	힃
ㅎㅢㅋ	힄
ㅎㅢㅌ	힅
ㅎㅢㅍ	힆
ㅎㅢㅎ	힇
ㅎㅣ	히
ㅎㅣㄱ	힉
ㅎㅣㄲ	힊
ㅎㅣㄳ	힋
ㅎㅣㄴ	힌
ㅎㅣㄵ	힍
ㅎㅣㄶ	힎
ㅎㅣㄷ	힏
ㅎㅣㄹ	힐
ㅎㅣㄺ	힑
ㅎㅣㄻ	힒
ㅎㅣㄼ	힓
ㅎㅣㄽ	힔
ㅎㅣㄾ	힕
ㅎㅣㄿ	힖
ㅎㅣㅀ	힗
ㅎㅣㅁ	힘
ㅎㅣㅂ	힙
ㅎㅣㅄ	힚
ㅎㅣㅅ	힛
ㅎㅣㅆ	힜
ㅎㅣㅇ	힝
ㅎㅣㅈ	힞
ㅎㅣㅊ	힟
ㅎㅣㅋ	힠
ㅎㅣㅌ	힡
ㅎㅣㅍ	힢
ㅎㅣㅎ	힣
